Title	Category
Northern grasshopper mouse	Other/None
Province of canada	redirect::Province of Canada
MY Steve Irwin	Other
RV Robert Hunter	redirect::MY Steve Irwin
Baron Macmillan	redirect::Hugh Macmillan, Baron Macmillan
Vandenberg Space Launch Complex 10	A_Location
There It Is (911 album)	Other
Georgios Papandreou (historian)	Person
Marcos Antônio Malachias Junior	redirect::Marquinhos (footballer, born April 1982)
New improved song (song)	redirect::The Real Thing (Faith No More album)
Ultrasonic Hydroponic Fogger	redirect::Ultrasonic hydroponic fogger
Codorniu	redirect::Codorníu Winery
Template:Lake County, Oregon	Other/None
Museum of Science and Industry (Tampa, Florida)	redirect::Museum of Science & Industry (Tampa)
Elephant Theatre Company	Other/None
Balikpapan class	redirect::Balikpapan-class landing craft heavy
Nadișa River	redirect::Tazlău (river)
ECPI University	Other
Aretha Sings the Blues	Other
Category:Poets from Achaea	Other/None
Category:French Latter Day Saints	Other/None
Frederick Augustus Rutowsky	Person
Ibrahim Somé Salombo	Person
Harpsong	Other
TIAM1	redirect::T-cell lymphoma invasion and metastasis-inducing protein 1
Template:Harney County, Oregon	Other/None
Hung Out to Dry (CSI: NY)	redirect::CSI: NY (season 3)
Banished (film)	C_Organization
James R. Goodman	C_Person
Wapama (steam schooner)	C_Location
Ibrahim Some Salombo	redirect::Ibrahim Somé Salombo
Bangladeshi cricket team in New Zealand in 2007–08	Other
Faintness	redirect::Syncope (medicine)
Wikipedia:ARB/PARA	redirect::Wikipedia:Requests for arbitration/Paranormal
Port of Yantai	Other/None
James Lucas Scott	redirect::List of One Tree Hill characters
13th General Assembly of Prince Edward Island	Other/None
Port of Weihai	Other/None
Ray parker	redirect::Ray Parker Jr.
Ivo Cappo	Other/None
Template:Malheur County, Oregon	Other/None
St. Paul's Episcopal Church, Rock Creek Parish (Washington, D.C.)	Location
Acymba	redirect::Lacydes (moth)
Soulcatcher	C_Organization
Accatone!	redirect::Accattone
Qingdao Port	Other/None
Super Men	redirect::CSI: NY (season 2)
Music sequencing	redirect::Music sequencer
Template:Noontime variety shows in the Philippines	Other/None
DirectRevenue	redirect::Direct Revenue
Addua	redirect::Adda (river)
Adites (moth)	redirect::Asura (moth)
Adoxosia	Other/None
Adrepsa	Other/None
Woy Woy Aerodrome	A_Location
Let's Dance (5ive song)	redirect::Let's Dance (Five song)
Alaska Rural Communications Service	C_Location
Marquinhos (footballer, born 1971)	Person
Catalan wine	Other/None
Marcos Correia dos Santos	redirect::Marquinhos (footballer, born 1971)
Scene of the Crime (1986 film)	Other
List of Ghostbusters games	redirect::List of Ghostbusters video games
Mediterranean coast	redirect::Mediterranean Sea
QUAD (compressor)	Other/None
Papel amate	redirect::Amate
Sugar and Spice (Australian TV series)	Other
Analog audio	redirect::Analog recording
Aedoea	Other/None
Aemene	Other/None
Kokusai Ki-86	redirect::Bücker Bü 131
Aemilia (moth)	Other/None
Shark Sucker	redirect::Remora
Anacostia Railroad Bridge	Location
Aeolosia	Other/None
Aethalida	Other/None
Georgios Papandreou (writer)	redirect::Georgios Papandreou (historian)
Pefkakia station	A_Location
Battle of Războieni	redirect::Battle of Valea Albă
Theodoric Schenk of Erbach	redirect::Dietrich Schenk von Erbach
Template:Coos County, Oregon	Other/None
Category:Companies based in St. Petersburg, Florida	Other/None
Aleta Wendo	Location
Category:Libraries in Peru	C_Organization
HMH-366	Other
Marine Heavy Helicopter Squadron 366	redirect::HMH-366
Category:People from Aalborg	Other/None
Step on It! (video game)	Other
HMH 366	redirect::HMH-366
Kevork çavuş	redirect::Kevork Chavush
Step On It	redirect::Step on It
Solenopsis molesta	Other/None
Template:University of Denver	Other/None
Pansá Blanca	redirect::Xarel·lo
The Young Family	redirect::Red Top Young
Pansa Blanca	redirect::Xarel·lo
Aethosia	Other/None
Aethria	Other/None
Pseudodimentia	redirect::Pseudodementia
Xarel lo	redirect::Xarel·lo
Aethriopsis	redirect::Diptilon
