Title	Category
Abou Ben Adhem	redirect::Ibrahim ibn Adham
Phil Anderson (cyclist)	Person
Tangsa Naga	Other
Platyhelminthes	redirect::Flatworm
Club Universidad de Chile	Other
Vossem, Belgium	C_Location
Televisão Independente	C_Location
Abu-Al-Abbas	redirect::As-Saffah
Canadian Thanksgiving	redirect::Thanksgiving (Canada)
Human User Interface guidelines	redirect::Human interface guidelines
Websafe colors	redirect::Web colors#Web-safe colors
Websafe	redirect::Web colors#Web-safe colors
Nintendo Software Technology	Company
Unicomplex	redirect::Borg#Unicomplex
Livescript	redirect::LiveScript
Susan Glaspell	Person
Ride With The Devil	redirect::Ride with the Devil
The Rime	redirect::Le Rime
Christian coalition	redirect::Christian Coalition
Keith Hoerig	Person
Shun Goku Satsu	redirect::Akuma (Street Fighter)
Queen's Westminsters	Other
Copperhead Road	Other
Chainfire	Other
Walter Jones (Virginia politician)	A_Person
Name days in the Czech Republic	Other/None
Abu Bakr ibn Umar	Person
Upbeats and Beatdowns	Other
Uni-Complex	redirect::Borg#Unicomplex
Meta-moderation	redirect::Meta-moderation system
Permanent secretary	Other/None
The Ui Neill	redirect::Uí Néill
George Herman (journalist)	C_Person
Tara Nelson	C_Person
Titania's Palace	Other/None
Nancy Cartright	redirect::Nancy Cartwright
Nurestan	redirect::Nuristan Province
The Gospel According to Spiritism	Other/None
ABC Society	redirect::Action for Bright Children Society
The Connachta	redirect::Connachta
Yarrow oil	Other/None
Sunshine of your love	redirect::Sunshine of Your Love
Geometrical frustration	Other/None
Category:Energy therapies	Other/None
Brion, son	redirect::Brión mac Echach Muigmedóin
Queen Mongfind	redirect::Mongfind
Rodrigo	Other/None
Seto Uchi Jakucho	redirect::Jakucho Setouchi
Pervenche Beres	redirect::Pervenche Berès
Pearl Harbor (attack)	redirect::Attack on Pearl Harbor
Sofia Metro	C_Location
Mexican Federal Highway	Other
Action for Bright Children Society	Other/None
Cidadania	Other
LDE(X)	Other
Los Capos	Other
Kader Arif	C_Person
Guy Bono	C_Person
Bernadette Bourzai	Person
Pozen Conference	redirect::Posen speeches
Marie-Arlette Carlotti	C_Person
Marie Arlette Carlotti	redirect::Marie-Arlette Carlotti
The Lay of the Cid	redirect::Cantar de mio Cid
Françoise Castex	C_Person
M-125 (Michigan highway)	Other
Jean-Louis Cottigny	C_Person
Jean Louis Cottigny	redirect::Jean-Louis Cottigny
Harlem Désir	Person
Mitsubishi Aluminum Co.	C_Company
Harlem Desir	redirect::Harlem Désir
Brigitte Douay	C_Person
Category:Acupuncture	Other/None
Anne Ferreira	C_Person
Cannabis (law)	redirect::Legality of cannabis
Category:Closed railways in Ireland	Other/None
Walter B. Jones Sr.	A_Person
Monodactylus sebae	Other/None
Walter Beaman Jones, Sr.	redirect::Walter B. Jones Sr.
Carolina Theatre (Durham)	Location
Natural Light	C_Company
Gardelegen massacre	C_Organization
Jean-Claude Fruteau	C_Person
Dan Castellanetta	redirect::Dan Castellaneta
Jean Claude Fruteau	redirect::Jean-Claude Fruteau
Catherine Guy-Quint	C_Person
Catherine Guy Quint	redirect::Catherine Guy-Quint
Benoît Hamon	Person
Benoit Hamon	redirect::Benoît Hamon
Soccer (dog)	A_Person
Zliv	Location
Adeline Hazan	C_Person
Two Face	redirect::Two-Face
André Laignel	C_Person
Andre Laignel	redirect::André Laignel
Oil for Food program	redirect::Oil-for-Food Programme
Protoculture	Other/None
Stéphane Le Foll	C_Person
Battered woman syndrome	Other
Los Guerreros Laguneros	Other
Stephane Le Foll	redirect::Stéphane Le Foll
