Title	Category
Integration and testing	redirect::Integration testing
Langnoes	redirect::Langnes, Troms
Integration & testing	redirect::Integration testing
Langnäs	redirect::Langnes, Troms
Home sickness	redirect::Homesickness
Langnæs	redirect::Langnes, Troms
Kentaro Kaneko	redirect::Kaneko Kentarō
Maersk UK	redirect::Maersk Air UK
Melavonate	redirect::Mevalonic acid
Nippletop Mountain	redirect::Nippletop
Flour milling	redirect::Gristmill
The Hair Bear Bunch	redirect::Help!... It's the Hair Bear Bunch!
Line of succession to the Liechtensteiner Throne	redirect::Succession to the Liechtensteiner throne
Langenes, Finnmark	Location
Langnes, Troms	Location
Union square manhattan	redirect::Union Square, Manhattan
List of Scottish Football League clubs	Other/None
Houstonia longifolia	Other/None
Committee for Culture, Arts and Leisure	Other/None
No W	Other
Lomita Park, California	Location
Malverde (musician)	C_Person
An Awfully Big Adventure	C_Person
Golden Globe Award for Best Supporting Actor — Motion Picture	redirect::Golden Globe Award for Best Supporting Actor – Motion Picture
Canada Science and Technology Museum	Location
Georgina von Wilczek	redirect::Countess Georgina von Wilczek
Langenæs	Location
1972–73 St. Louis Blues season	Other
1974–75 St. Louis Blues season	Other
Stormie O'Martian	redirect::Stormie Omartian
Category:History of Johannesburg	Other/None
Wikipedia:Peer review/Pied-noir/archive1	redirect::Wikipedia:Peer review/Pied-Noir/archive1
International cricket in 2008–09	Other/None
1987–88 St. Louis Blues season	Other
Extra chromosomes	redirect::Aneuploidy
Albanian Orthodox church	redirect::Orthodox Church of Albania
1988–89 St. Louis Blues season	Other/None
List of atomic elements	redirect::List of chemical elements
Barts Girlfriend	redirect::Bart's Girlfriend
Die Young (Black Sabbath song)	redirect::Heaven and Hell (Black Sabbath album)
Korphe	Location
1991–92 St. Louis Blues season	Other/None
1992–93 St. Louis Blues season	Other/None
2008 Lebanese conflict	redirect::2008 conflict in Lebanon
Ming-Jun Lai	C_Person
Langenes, Vestland	Location
Miller Rule	redirect::Miller test
William Chinyama	redirect::Willy Chinyama
Category:Polish exiles in the Russian Empire	C_Person
Category:Olympic bobsledders of Norway	C_Person
Bjarne Schroen	redirect::Bjarne Schrøen
1972–73 New York Rangers season	Other
2005-2006 LEB season	redirect::2005–06 LEB season
AICPA Accounting Principles Board	redirect::Accounting Principles Board
LongPen	Other/None
Wyoming counties ranked by per capita income	redirect::List of Wyoming locations by per capita income
2006-2007 LEB season	redirect::2006–07 LEB season
Cedarcroft, Baltimore	Location
Wyoming places ranked by per capita income	redirect::List of Wyoming locations by per capita income#Wyoming places ranked by per capita income
St Margaret's school, Bushey	redirect::St Margaret's School, Bushey
Bay Island	Location
1999–2000 New Jersey Nets season	Other/None
2002–03 New Jersey Nets season	Other/None
Longpen	redirect::LongPen
Fanshi	redirect::Fanshi County
GLITS	Other/None
1975–76 New York Nets season	Other
Great Observatories Origins Deep Survey	Other
Physician Data Query	Other/None
John A. Logan (Medal of Honor)	redirect::John Alexander Logan Jr.
Crowbar circuit	redirect::crowbar (circuit)
National Geographic Institute (Belgium)	Other/None
Filip Polášek	Person
John Patrick Barigye	redirect::Ntare VI of Ankole
GOODS Survey	redirect::Great Observatories Origins Deep Survey
Margaret Woodbury Strong	C_Person
Alvin Colt	Other/None
Daixian	redirect::Dai County
Warehouse 13	Other
Jacinto-class patrol vessel	Other
Template:SlovakMinisterJustice	Other/None
Vy bus4you	Other
HTC Touch Diamond	Other
Woman symbol	redirect::Gender symbol
Incredible (Clique Girlz album)	Other
The Flower Pot Men (band)	redirect::The Flower Pot Men
The Dangerous Flirt	Other
Prof. Gerald	redirect::List of Sonic the Hedgehog characters#Professor Gerald Robotnik
Flight West	redirect::Flight West Airlines
Periwinkle blue	redirect::Periwinkle (color)
Dangerous Flirt	redirect::The Dangerous Flirt
House Office Building Commission	Other/None
Festival of the Three Kings	redirect::Epiphany (holiday)
Kirill Yevstigneyev	Person
Wikipedia:Featured picture candidates/Baha'i temple	Other/None
Category:Albums produced by Tony Bongiovi	Other/None
1904–05 Southern Football League	Other
Bede Wing	Other
Rob Kardashian	Person
2003 Men's European Water Polo Championship	Other/None
