Title	Category
Delphian Records	C_Company
Severny Vestnik	Other
Owen Lovejoy Homestead	redirect::Owen Lovejoy House
Satan Watching the Endearments of Adam and Eve	redirect::William Blake's illustrations of Paradise Lost
The Very Best of The Human League (1998 album)	Other
When I Grow Up (The Pussycat Dolls song)	Other
Algonquin Nation	redirect::Algonquin people
Full House (British TV series)	Other
Spann-fischer	redirect::Spann-Fischer Codependency Scale
Blues for Sister Someone	redirect::Grey's Anatomy (season 2)
The Sun & the Neon Light	Other
Dennis & Gnasher	redirect::Dennis the Menace and Gnasher
Diving bell and the butterfly	redirect::The Diving Bell and the Butterfly
Matta echaurren	redirect::Roberto Matta
The Road of Azrael	Other/None
Template:Rajasthan Royals Squad 2008	redirect::Template:Rajasthan Royals squad
Period Piece Films	redirect::List of historical drama films and series set in Near Eastern and Western civilization
Andy Willock	Person
Broadway-Flushing	redirect::Broadway–Flushing, Queens
Damage Case	redirect::Grey's Anatomy (season 2)
Raw (Sex Pistols album)	redirect::Sex Pistols
List of period piece films	redirect::List of historical drama films and series set in Near Eastern and Western civilization
Aleksander Delchev	A_Person
Ustaoset Station	C_Location
Alexander Delchev	redirect::Aleksander Delchev
Jathika Nidahas Peramuna	Other
Right to Exist: a Moral Defense of Israel's Wars	Other
Justin Herman	Person
Alain Corbin	C_Person
Porteous riots	redirect::Porteous Riots
Justin B. Herman	redirect::Justin Herman
Situation (song)	Other
Cabin crew member	redirect::Flight attendant
Neoclassical Revival	redirect::Neoclassical architecture
The Neeley School of Business at TCU	redirect::Neeley School of Business
Δ-Y transformer	redirect::Delta-wye transformer
Titular bishop of Mallus	redirect::Mallus (Cilicia)
Perioperative Medicine	redirect::Perioperative medicine
Dock.app	redirect::Dock (macOS)
Titular Bishop of Malla	redirect::Mallus (Cilicia)
Skills Canada	Other/None
Newhall incident	C_Organization
Robert Tasker	C_Person
Co-occurrence network	Other/None
Fulton County Courthouse (Georgia)	Location
Pit trap	redirect::Trapping pit
CR-S18 (CA)	redirect::California County Routes in zone S#S18
Period Piece Movies	redirect::List of historical drama films and series set in Near Eastern and Western civilization
Palm Springs Mile	redirect::Florida State Road 932
Longmen Mountains	Location
Osdorp	Location
Apollo in the Forge of Vulcan	Other
Category:Grey's Anatomy episode images	Other/None
1965–66 Cincinnati Royals season	Other/None
John K Samson	redirect::John K. Samson
LeJune Road	redirect::Florida State Road 953
Martin Drent	Person
Finse Station	A_Location
Milam Dairy Road	redirect::Florida State Road 969
1881-82 Australia v England series	redirect::English cricket team in Australia and New Zealand in 1881–82
John Kristjan Samson	redirect::John K. Samson
Gocha Khojava	Person
Whidden & Lewis	Other/None
Dion Cass.	redirect::Cassius Dio
Arthur Grant (footballer)	Person
Lift and strike (Bosnian War)	Other/None
Fer (disambiguation)	redirect::FER
Kenneth Hopper	C_Person
Largest prime	redirect::Largest known prime number
Severní	C_Location
The Want (NJ band)	redirect::The Want (New Jersey band)
Setubinha	Location
Real Time Media Flow Protocol(RTMFP)	redirect::Real-Time Media Flow Protocol
Bird Avenue	redirect::Bird Road
Sons of Liberty (film)	C_Person
Boombarash	redirect::Bumbarash
Ber, Greece	redirect::Veria
Glanshammar Hundred	redirect::List of hundreds of Sweden
Lion of Idaho	redirect::William Borah
Category:Roman towns and cities in Iraq	C_Location
Capitol of the State of New Mexico	redirect::New Mexico State Capitol
Grangärde Court District	redirect::Grangärde
Jean-François Landriot	redirect::Jean-François-Anne Landriot
Allapattah Road	redirect::Florida State Road 989
When I Grow Up (the Pussycat Dolls song)	redirect::When I Grow Up (The Pussycat Dolls song)
Golikov	Other/None
Big Red Tequila	Other
Category:Roman sites in Iraq	Other/None
1969–70 Cincinnati Royals season	Other/None
Sciencenter	C_Location
1880 Australia v England series	redirect::Australian cricket team in England in 1880
Situation (Yazoo song)	redirect::Situation (song)
Fort Wayne Flash	Other/None
South Kendall Drive	redirect::Florida State Road 990
1970–71 Cincinnati Royals season	Other/None
Artful Dodge	Other
Gaia Liberation Front	redirect::Gaia philosophy
Declaration of Independence (short film)	redirect::Declaration of Independence (film)
Indiana Pacers all-time roster	Other/None
1971–72 Cincinnati Royals season	Other/None
