Title	Category
Category:World Sportscar Championship races	Other/None
Zapruder film	Other/None
Giovanni Pandico	C_Person
Category:Amtrak stations in Santa Barbara County, California	C_Location
Shadowman (1973 film)	redirect::Nuits Rouges
Puerto Pirámides	Location
Strabismic	redirect::strabismus
Category:Railway stations in Santa Barbara County, California	C_Location
Shakespeare-Wallah	redirect::Shakespeare Wallah
Foo Tye Sin	Other/None
Category:Radio stations in Traverse City, Michigan	C_Location
Category:Public transportation in Santa Barbara County, California	Other/None
Spaghetti Cat	"redirect::The Morning Show with Mike and Juliet#""Spaghetti Cat"" incident"
Shoot the Moon (film)	redirect::Shoot the Moon
Marcial del Adalid y Gurréa	Person
Parody	Other/None
The Siege of Alcazar	redirect::The Siege of the Alcazar
Dance of the Headless Bourgeoisie	Other
Pocket Change (arcade)	redirect::Namco#International arcade operations
Plagiarism	Other/None
Category:Railway stations in Butte County, California	C_Location
Manin obstruction	Other/None
Category:Transportation in Butte County, California	Other/None
Nian Nu Jiao: Chibi Huai Gu	redirect::Su Shi
La signora di tutti	redirect::Everybody's Woman
Leningrad Technological Institute	redirect::Saint Petersburg State Institute of Technology
All-Union Communist Party of Bolsheviks	redirect::All-Union Communist Party
Category:Radio stations in Ann Arbor, Michigan	C_Location
Miss Teen USA 2009	Other
Category:Mass media in Ann Arbor, Michigan	Other/None
Verada	redirect::Mitsubishi Magna
National Organization of the Scouts of Ukraine	Organization
Trisha Thoon	redirect::List of Arrested Development characters#Trisha Thoon
Payg	redirect::Pay as you go
Ihsan Ali Al-Shehbaz	C_Person
Little Galleries of the Photo-Secession	redirect::291 (art gallery)
Ihsan Al-Shehbaz	redirect::Ihsan Ali Al-Shehbaz
Category:Olympic athletes of Costa Rica	C_Person
MIL-STD-130	Other/None
Category:Radio stations in Flint, Michigan	C_Location
Starla (Arrested Development)	redirect::List of Arrested Development characters
Category:Mass media in Flint, Michigan	Other/None
Termination (chemistry)	redirect::Radical (chemistry)#Depiction_in_chemical_reactions
Wayne Jarvis	redirect::List of Arrested Development characters#Wayne Jarvis
Suzie Chapstick	redirect::Suzy Chaffee
Gairloch Stone	Other/None
Lupe (Arrested Development)	redirect::List of Arrested Development characters#Lupe
Antón Paz	C_Person
Richie Moller	Person
Larry Mittleman	redirect::List of Arrested Development characters
Shuhov Tower	redirect::Shukhov Tower
Monica Noguera	redirect::Mónica Noguera
Gotemburgo	redirect::Gothenburg
John Beard (Arrested Development)	redirect::List of Arrested Development characters#John Beard
Template:Netherlands FH Squad 2008 Summer Olympics	C_Person
Turn Out the Lights (TV series)	Other
A Frank Exploration of Voyeurism and Violence	Other
Tony Wonder	redirect::List of Arrested Development characters#Tony Wonder
Mac Donnell Douglas MD-82	redirect::McDonnell Douglas MD-80
Spirit of Manila destinations	redirect::Spirit of Manila Airlines#Destinations
Belinda Wright (softball)	Person
Everard Carpenter	redirect::Eddie Carpenter
Mac Donnell Douglas	redirect::McDonnell Douglas
Zizhuyuan	redirect::Purple Bamboo Park
Category:Education in Flint, Michigan	Other/None
Zizhuyuan Park	redirect::Purple Bamboo Park
Francis Carpenter	redirect::Francis Bicknell Carpenter
The Royal Scottish Society of Painters in Watercolour	redirect::Royal Scottish Society of Painters in Watercolour
Innocent (2009 film)	Other
Anton Paz	redirect::Antón Paz
Category:Medal infobox templates	C_Person
1995 State of Origin	redirect::1995 State of Origin series
Exfoliation corrosion	redirect::Intercalation (chemistry)#Exfoliation
One (Nomeansno album)	Other
Jayzges	redirect::Iazyges
Iazygite	redirect::Iazyges
The Lord of the Beans	redirect::List of VeggieTales videos#Lord of the Beans .282005.29
Epigenes, son of Antiphon	Other/None
Category:Buildings and structures in Flint, Michigan	C_Location
Marching triangles	Other/None
Mort Meyers	redirect::List of Arrested Development characters#Mort Meyers
State Route 103 (Utah)	redirect::Utah State Route 103
SR-103 (UT)	redirect::Utah State Route 103
Poolewe Stone	Other/None
Category:Diplomatic missions in Georgia (country)	Other/None
Category:Medical technology	Other/None
Category:Ambassadors of Russia to Georgia (country)	Other/None
Template:Transwikied to Wiktionary/doc	Other/None
Category:Ambassadors to Georgia (country)	C_Person
Category:Buildings and structures in Ann Arbor, Michigan	C_Location
Hope Loblaw	redirect::List of Arrested Development characters
Dian Grueneich	C_Person
Youjia Luo	redirect::Luo Youjia
Xiuke Chen	redirect::Chen Xiuke
Mark Beaumont (cyclist)	Person
Criticism of World Championship Wrestling	redirect::History of World Championship Wrestling
Rose-Eliandre Bellemare	Person
Epigenes of Athens	Other/None
Peng Zhang	redirect::Zhang Peng
Google Custom Search Engine	redirect::Google Programmable Search Engine
