Title	Category
AccessibleComputing	redirect::Computer accessibility
Anarchism	Other/None
AfghanistanHistory	redirect::History of Afghanistan
AfghanistanGeography	redirect::Geography of Afghanistan
AfghanistanPeople	redirect::Demographics of Afghanistan
AfghanistanCommunications	redirect::Communications in Afghanistan
AfghanistanTransportations	redirect::Transport in Afghanistan
AfghanistanMilitary	redirect::Afghan Armed Forces
AfghanistanTransnationalIssues	redirect::Foreign relations of Afghanistan
AssistiveTechnology	redirect::Assistive_technology
AmoeboidTaxa	redirect::Amoeba
Autism	Other
AlbaniaHistory	redirect::History of Albania
AlbaniaPeople	redirect::Demographics of Albania
AsWeMayThink	redirect::As_We_May_Think
AlbaniaGovernment	redirect::Politics of Albania
AlbaniaEconomy	redirect::Economy of Albania
Albedo	Other/None
AfroAsiaticLanguages	redirect::Afroasiatic languages
ArtificalLanguages	redirect::Constructed language
AbacuS	redirect::Abacus
AbalonE	redirect::Abalone
AbbadideS	redirect::Abbadid dynasty
AbbesS	redirect::Abbess
AbbevilleFrance	redirect::Abbeville
AbbeY	redirect::Abbey
AbboT	redirect::Abbot
Abbreviations	redirect::Abbreviation
AtlasShrugged	redirect::Atlas Shrugged
ArtificialLanguages	redirect::Constructed language
AtlasShruggedCharacters	redirect::List of Atlas Shrugged characters
AtlasShruggedCompanies	redirect::Atlas Shrugged
AyersMusicPublishingCompany	redirect::Atlas Shrugged
AfricanAmericanPeople	redirect::African Americans
AdolfHitler	redirect::Adolf Hitler
AbeceDarians	redirect::Abecedarian
AbeL	redirect::Cain and Abel
AbensbergGermany	redirect::Abensberg
AberdeenSouthDakota	redirect::Aberdeen, South Dakota
ArthurKoestler	redirect::Arthur Koestler
AynRand	redirect::Ayn Rand
AlexanderTheGreat	redirect::Alexander the Great
AnchorageAlaska	redirect::Anchorage, Alaska
ArgumentForms	redirect::Logical form
ArgumentsForTheExistenceOfGod	redirect::Existence of God
AnarchY	redirect::Anarchy
AsciiArt	redirect::ASCII art
AcademyAwards	redirect::Academy Awards
AcademyAwards/BestPicture	redirect::Academy Award for Best Picture
AustriaLanguage	redirect::Austrian German
AcademicElitism	redirect::Ivory tower
AxiomOfChoice	redirect::Axiom of choice
AmericanFootball	redirect::American football
AmericA	redirect::United States
AnnaKournikova	redirect::Anna Kournikova
AndorrA	redirect::Andorra
AustroAsiaticLanguages	redirect::Austroasiatic languages
ActresseS	redirect::Lists of actors
A	Other
AnarchoCapitalism	redirect::Anarcho-capitalism
AnarchoCapitalists	redirect::anarcho-capitalism
ActressesS	redirect::Lists of actors
AnAmericanInParis	redirect::An American in Paris
AutoMorphism	redirect::Automorphism
ActionFilm	redirect::Action film
Alabama	Location
AfricA	redirect::Africa
Achilles	Other/None
AppliedStatistics	redirect::Statistics
Abraham Lincoln	Person
Aristotle	Person
An American in Paris	Other/None
Academy Award for Best Production Design	Other
Academy Awards	C_Person
Action Film	redirect::Action film
Actrius	Other
Animalia (book)	Other
International Atomic Time	Other/None
Altruism	Other/None
AutoRacing	redirect::Auto racing
Ayn Rand	Person
Alain Connes	Person
Allan Dwan	Person
Algeria/People	redirect::Demographics of Algeria
Algeria/Transnational Issues	redirect::Foreign relations of Algeria
Algeria	Location
List of Atlas Shrugged characters	Other/None
Topics of note in Atlas Shrugged	redirect::Atlas Shrugged
Anthropology	Other/None
Agricultural science	Other/None
Alchemy	Other/None
Astronomer	Other/None
Ameboid stage	redirect::Amoeba
ASCII	Other
Ashmore And Cartier Islands	redirect::Ashmore and Cartier Islands
Animation	Other/None
Apollo	Other
Andre Agassi	Person
Artificial languages	redirect::Artificial language
Austroasiatic languages	Other
