Title	Category
Sayf al-Din Ghazi II	Other/None
Template:Bishops of British Columbia	Other/None
Lower Bhavani Project Canal	Location
Narayanhat Union	Other/None
Josiah Dubois	redirect::Josiah E. DuBois Jr.
Maria Albin Boniecki	C_Person
Eunech	redirect::Eunuch
Category:Conflicts in 1771	Other/None
Category:Buildings and structures in Wrexham County Borough	Other/None
Mornington Peninsula Regional Gallery Works on Paper Award	Other/None
Knaresdale	redirect::Knarsdale
Air New Zealand A320 test flight crash (2008)	redirect::XL Airways Germany Flight 888T
Knarsdale	Location
Kv√¶rner Masa-Yards	redirect::STX Finland
File:Misfits - Scream!.ogg	Other/None
ISO 3166-2:GB-SOM	redirect::ISO 3166-2:GB
Category:Aqueducts in Wales	Other/None
Obstructive Sleep Apnoea	redirect::Obstructive sleep apnea
Netherwitton	Location
Parasnath temple, kolkata	redirect::Calcutta Jain Temple
Rennington	Location
Machu Pikchu	redirect::Machu Picchu
Mirudhubashini Govindarajan	C_Person
Spanaway Lake	redirect::Spanaway Lake High School
GWAR	redirect::Gwar
Category:Buildings and structures in Torfaen	Other/None
ISO 3166-2:GB-BST	redirect::ISO 3166-2:GB
Pinyehrae Schiffer	redirect::Roy Pinney
Category:Buildings and structures in Gwynedd	Other/None
Teri University	redirect::TERI School of Advanced Studies
World Conference against Racism 2009	redirect::Durban Review Conference
Municipal Park (Luxembourg City)	Location
City Park (Luxembourg City)	redirect::Municipal Park (Luxembourg City)
Durban II	redirect::Durban Review Conference
Parc de la Ville	redirect::Municipal Park (Luxembourg City)
Durban 2	redirect::Durban Review Conference
William Perrin (bishop)	C_Person
A1 County Route (California)	redirect::California County Routes in zone A#A1
County Route A1 (California)	redirect::California County Routes in zone A#A1
Frank P. Armstrong	Person
Beit Ijza	Location
Hug tornado	redirect::Kick#Advanced kicks
Common Spoonbill	redirect::Eurasian spoonbill
Timarion	Other/None
Wang Yani	C_Person
William Henry Hance	A_Person
Battery (electric)	redirect::Electric battery
School Certificate (United Kingdom)	Other/None
Duvauchelle	C_Location
Single cell thunderstorm	redirect::Pulse storm
Category:Buildings and structures in Ceredigion	Other/None
Category:Conflicts in 1755	Other/None
Single-cell	redirect::Single cell
Template:UTV Media	redirect::Template:Wireless Group
Category:Buildings and structures in Blaenau Gwent	Other/None
Fortescue River	Location
A1 county route (California)	redirect::California County Routes in zone A#A1
A1 road (California)	redirect::California County Routes in zone A#A1
The Best of Buffy Sainte-Marie Vol. 2	Other
Cercle Municipal	C_Location
List of people from Sylhet	Other/None
A1 road (England)	redirect::A1 road (Great Britain)
Troy Tate	Person
Luxembourg-Findel Airport	redirect::Luxembourg Airport
Average value option	redirect::Asian option
The Five Mysteries Program	Other/None
A1 road (Scotland)	redirect::A1 road (Great Britain)
Ashkenazy Jew	redirect::Ashkenazi Jews
Weather eye	redirect::Weather Eye
10:10 (film)	Other
Baie de Fundy	redirect::Bay of Fundy
Semipalatinsk test range	redirect::Semipalatinsk Test Site
Category:Wind farms in Wales	C_Location
Venice of the Orient	redirect::List of places called Venice of the East
Roy Heinrich	Person
Oxspring railway station	C_Location
Samuel Kamakau	Person
Gobbeldigook	redirect::Gibberish
Siege of Kolberg (1807)	Other
Adbhutananda	C_Person
Buntingville, California	Location
Takahiro Mori	Person
Buntingville	redirect::Buntingville, California
Buntingville, CA	redirect::Buntingville, California
Belgian Freemasonry	redirect::Freemasonry in Belgium
Hilton Glasgow	Other
I'm a Celebrity...Get Me Out of Here! (British series 4)	Other
Sons of Katie Elder	redirect::The Sons of Katie Elder
The Sons of Katy Elder	redirect::The Sons of Katie Elder
Kasher (surname)	Other/None
Sons of Katy Elder	redirect::The Sons of Katie Elder
Kaliprasad Chandra	redirect::Swami Abhedananda
HMAS Vigilant	Other
Category:Transmitter sites in Wales	Other/None
Germantown, Quincy, Massachusetts	redirect::Germantown (Quincy, Massachusetts)
Template:Italy Labelled Map	Other/None
PFC Lokomotiv Stara Zagora	Other
Right to Dream	Other
4+1	redirect::4+1 architectural view model
BKK	redirect::Suvarnabhumi Airport
