Title	Category
Paul Crête	Person
Danger Lights	Other
Jænberht	Person
Category:Terrorist incidents in 2002	Other/None
List of world's largest economies	redirect::Lists of countries by GDP
Category:Terrorist incidents in 2001	Other/None
TJNAF	redirect::Thomas Jefferson National Accelerator Facility
New Economics Foundation	C_Organization
Metaperiodic acid	redirect::periodic acid
Orthoperiodic acid	redirect::periodic acid
C-38 bill	redirect::Civil Marriage Act
Toronto/Lester B. Pearson International Airport	redirect::Toronto Pearson International Airport
Crenshinibon	redirect:: The Icewind Dale Trilogy#Plot summary
Robb Report	Other
George Mason High School	Other
Carl Pomerance	C_Person
Ma Wan Channel	Other/None
IC Entertainment	redirect::Studio Ironcat
Category:History of the Soviet Union	Other/None
Siti Wan Kembang	Other/None
Crystal Shard	redirect::The Icewind Dale Trilogy
Poompuhar	redirect::Puhar, Mayiladuthurai
Strzelecki	redirect::Paweł Strzelecki
Ray Holmes	Person
Teutonic race	redirect::Nordic race
Cryshal-Tirith	redirect::The Icewind Dale Trilogy#Plot summary
Miss Goldenweek	redirect::List of One Piece characters#Ms. Golden Week
Wikipedia:Evangelical Dictionary of Theology/A	redirect::Wikipedia:Evangelical Dictionary of Theology
Metro Detroit area	redirect::Metro Detroit
Sron-btsan sgam-po	redirect::Songtsen Gampo
Ingeborg Hallstein	Person
City of Detroit	redirect::Detroit
Vaccinov	redirect::Smallpox#Eradication
Clinton Creek	C_Location
Michel Biron	A_Person
Cullen Bullen, New South Wales	C_Location
Sherpa (people)	redirect::Sherpa people
Queen's University Faculty of Arts and Sciences	Other
Route 2 (Hong Kong)	Other
Paddy Considine	Person
Mariano Álvarez	Person
Treaty of Friendship and Alliance Between the Government of Mongolia and Tibet	redirect::Treaty of friendship and alliance between the Government of Mongolia and Tibet
Harald Weiss	C_Person
Colonel Flagg	redirect::List of M*A*S*H characters#Colonel (Sam) Flagg
William Thompson (confidence man)	Other/None
NIME	redirect::New Interfaces for Musical Expression
Ram Karmabhoomi	redirect::Adam's Bridge
Feature (linguistics)	Other/None
The Black Ships	redirect::Black Ships
Gogo (Final Fantasy)	redirect::Characters of Final Fantasy VI#Gogo
Template:Fresno County, California	Other/None
Mun Tsai Tong	Other/None
Birdwing	Other/None
Troides	redirect::Birdwing
Wikipedia:Evangelical Dictionary of Theology/B	redirect::Wikipedia:Evangelical Dictionary of Theology
Ornithoptera	redirect::Birdwing
Birdwings	redirect::Birdwing
Walter Zimmermann	C_Person
Birdwing butterfly	redirect::Birdwing
Trogonoptera	redirect::Birdwing
Ted Hill (Australian communist)	C_Person
Aspen Highlands	A_Location
Oracle Night	C_Person
The Morris Reserve	redirect::Phelps and Gorham Purchase
Galvanize (song)	C_Person
Buttermilk (ski area)	A_Location
U-Tsang	redirect::Ü-Tsang
Haček	redirect::Caron
Template:Angkorian sites	Other/None
Wikipedia:Peer review/Black Ships	redirect::Wikipedia:Peer review/The Black Ships/archive1
Mass media in Sri Lanka	Other/None
Schinus terebinthifolia	Other/None
Believe (The Chemical Brothers song)	Other
Thomas Jefferson National Accelerator Facility	Other
List of newspapers in Sri Lanka	Other/None
Living with Lydia	Other
American pika	Other/None
Kangaroo River (Shoalhaven)	Location
Division of Wimmera	Other
Television in Sri Lanka	Other/None
The Boxer (The Chemical Brothers song)	Other
Ralph Goings	Person
Safari Off Road Adventure	Other/None
Radio in Sri Lanka	C_Location
Silver City (disambiguation)	redirect::Silver City
Panel painting	Other/None
Division of Yarra	Other
Watson brake	redirect::Watson Brake
Microeconomic reform	Other/None
Technical efficiency	redirect::X-inefficiency
Singing senators	redirect::The Singing Senators
Mercedes-Benz X-class	redirect::Mercedes-Benz X-Class
Division of Riverina (1901-84)	redirect::Division of Riverina
Division of Riverina-Darling	Other
1941 South American Championship	C_Organization
Havre-Saint-Pierre	Location
Coloring books	redirect::Coloring book
Carl Stone	C_Person
P2 Card	redirect::P2 (storage media)
Lindalino	C_Location
