Title	Category
CKGF-3-FM	redirect::CKQR-FM
Alpheiusa	redirect::Artemis#Epithets
Bethel high school (Hong Kong)	redirect::Bethel High School (Hong Kong)
Isca Greenfield-Sanders	Person
2d Air Division (United States)	redirect::2nd Air Division
3d Air Division (United States)	redirect::3rd Air Division
CKQK-FM-1	redirect::CKQK-FM
Category:Arhopala	Other/None
4th Air Division (United States)	redirect::4th Air Division
5th Air Division (United States)	redirect::5th Air Division
Hurricane One(1851)	redirect::1851 Atlantic hurricane season#Hurricane One
The Crazy Otto (Medley)	redirect::The Crazy Otto Medley
CKUA-FM-8	redirect::CKUA Radio Network
6th Air Division (United States)	redirect::6th Air Division
7th Air Division (United States)	redirect::7th Air Division
Leipzig Book Fair Prize	C_Organization
8th Air Division (United States)	redirect::8th Air Division
Close My Eyes (Sander van Doorn song)	Other
9th Space Division (United States)	redirect::9th Space Division
Siempre (Rocío Dúrcal album)	Other
10th Air Division (United States)	redirect::10th Air Division
The Lonely Bull (song)	redirect::The Lonely Bull
11th Air Division (United States)	redirect::11th Air Division
12th Air Division (United States)	redirect::12th Air Division
Julia Williams (academic)	C_Person
14th Air Division (United States)	redirect::14th Air Division
Hayley westrana	redirect::Hayley Westenra
Template:NHL on USA	Other/None
17th Air Division (United States)	redirect::17th Air Division
The Mummers Dance	redirect::The Mummers' Dance
19th Air Division (United States)	redirect::19th Air Division
20th Air Division (United States)	redirect::20th Air Division
Narathura bazalus	redirect::Arhopala bazalus
21st Air Division (United States)	redirect::21st Air Division
Musa Shafiq	redirect::Mohammad Musa Shafiq
Cirsium remotifolium	Other/None
24th Air Division (United States)	redirect::24th Air Division
Category:Major League Baseball players from Russia	C_Person
Category:Russian baseball players	C_Person
25th Air Division (United States)	redirect::25th Air Division
26th Air Division (United States)	redirect::26th Air Division
27th Air Division (United States)	redirect::27th Air Division
Cristian Popa	C_Person
28th Air Division (United States)	redirect::28th Air Division
29th Air Division (United States)	redirect::29th Air Division
Krittipol Paphunga	redirect::Kittipol Paphunga
30th Air Division (United States)	redirect::30th Air Division
31st Air Division (United States)	redirect::31st Air Division
Clock Tower Rome, Georgia	redirect::Clock Tower (Rome, Georgia)
32nd Air Division (United States)	redirect::32nd Air Division
CBAF-FM-13	redirect::CBAF-FM-5
Time After Time (INJO song)	redirect::Time After Time (Cyndi Lauper song)
CBBP-FM	redirect::CBL-FM
Francis Burke (Franciscan)	C_Person
Advocate (disambiguation)	redirect::The Advocate
Model RM2	redirect::Mendoza RM2
Alpheias	redirect::Arethusa (mythology)
CFCK-FM	redirect::Missinipi Broadcasting Corporation
Hatsu Hioki	Person
Tayutama: Kiss on my Deity	Other
Cirsium rhothophilum	Other/None
Columbus F.C.	redirect::ICSF Columbus FC
CFIN-FM-1	redirect::CFIN-FM
New Kids On The Blecch	redirect::New Kids on the Blecch
James Ashmore (basketball coach)	redirect::James N. Ashmore
Y(4140)	Other/None
CHOA-FM-2	redirect::CHOA-FM
Love's So Tough	Other
Eisenhower Monument	A_Location
John Brmingham	redirect::John Birmingham (astronomer)
Orthonormal bases	redirect::Orthonormal basis
I am best	redirect::Ai Am Best
I am Best	redirect::Ai Am Best
CILK-FM-1	redirect::CILK-FM
Guide to Modern World Literature	redirect::The Guide to Modern World Literature
Marge Versus The Monorail	redirect::Marge vs. the Monorail
Alpheius	redirect::Alpheus
Marge Vs. The Monorail	redirect::Marge vs. the Monorail
Hendrik van der Borcht	redirect::Hendrik van der Borcht the elder
Henry van der Borcht the elder	redirect::Hendrik van der Borcht the elder
Candler, NC	redirect::Candler, North Carolina
Henry van der Borcht	redirect::Hendrik van der Borcht the elder
VF2015	redirect::CISN-FM
Tokyu Flyers	redirect::Hokkaido Nippon-Ham Fighters
VF2103	redirect::CIRK-FM
VF2105	redirect::CISN-FM
VF2155	redirect::CKAC
Sungai rokam	redirect::Sungai Rokam
VF2377	redirect::CISN-FM
Erasmo Oneglia	Other/None
Kyuei Flyers	redirect::Hokkaido Nippon-Ham Fighters
Cirsium scariosum	Other/None
El Patrón	Other
Nittaku Home Flyers	redirect::Hokkaido Nippon-Ham Fighters
Nippon-Ham Fighters	redirect::Hokkaido Nippon-Ham Fighters
Largest nations	redirect::List of countries and dependencies by area
I Can't Stand the Rain (Ann Peebles song)	redirect::I Can't Stand the Rain (song)
Roy Thomson (Lord Thomson of Fleet)	redirect::Roy Thomson, 1st Baron Thomson of Fleet
Category:U.S. Presidents articles by quality	Other/None
Liliana Greenfield-Sanders	Person
