Title	Category
Diving at the 2010 South American Games – Men's 10 m platform	Other/None
Una Mestiza	Other
Courtyard with Lunatics	redirect::Yard with Lunatics
Recreation in Second Life	redirect::Second Life#Competitive entertainment
Analog coding	redirect::coding theory
Analog encryption	redirect::Coding theory#Analog coding
Courtenay station	A_Location
Analog VLSI	redirect::Very Large Scale Integration
Analog automata	redirect::Automata theory
Ondrej Mares	C_Person
Differential petri net	redirect::petri net
Hybrid process algebra	redirect::Process calculus
Sample spaces	redirect::Sample space
Wikipedia:Featured sound candidates/Lady Windermere's Fan	Other/None
Live on Air	redirect::Red Hot Chili Peppers
Jerzy Domaradzki	C_Person
Scandinavian Airlines Flight 871	redirect::Scandinavian Airlines System Flight 871
E.H.L.Krause	redirect::Ernst Hans Ludwig Krause
The Mestiza at Her Dressing Table	redirect::Una Mestiza
Mestiza at Her Dressing Table	redirect::Una Mestiza
The Mestiza	redirect::Una Mestiza
Babak Razi	Person
La mestiza en su tocador	redirect::Una Mestiza
Mestiza en su tocador	redirect::Una Mestiza
Mestiza Lady at Her Dresser	redirect::Una Mestiza
The Mestiza Lady at Her Dresser	redirect::Una Mestiza
Charing (painting)	redirect::Una Mestiza
Valet Girls	Other
Selena & The Scene	redirect::Selena Gomez & the Scene
The Helga Pictures	Other/None
Balthasar de Beaujoyeux	redirect::Balthasar de Beaujoyeulx
Rowing at the 2010 South American Games – Men's lightweight single sculls	Other/None
Rox montealegre	redirect::Rox Montealegre
Guilty (Octavia Sperati album)	redirect::Guilty (Octavia Sperati EP)
Epilogue (Epik High album)	Other
This Is Your Life (New Zealand TV series)	Other
This Is Your Life (Australian TV series)	Other
Schenectady Light Opera Company (SLOC)	redirect::Schenectady Light Opera Company
A Mestiza	redirect::Una Mestiza
St. John Catholic Church (Delphos, Ohio)	redirect::St. John's Catholic Church (Delphos, Ohio)
AKISAN National Convention	Other
Maxwell drummey	redirect::Chester French
No. 1300 (Meteorological THum) Flight RAF	redirect::No. 1300 Flight RAF
Maid-Droid	Other
No. 1300 (Meteorological Reconnaissance) Flight RAF	redirect::No. 1300 Flight RAF
No. 1300 (Meteorological) Flight RAF	redirect::No. 1300 Flight RAF
Saudi Association for Energy Economics (SAEE)	redirect::Saudi Association for Energy Economics
No. 1301 (Meteorological) Flight RAF	redirect::No. 1301 Flight RAF
Union Bay station	A_Location
Category:Houses in Salem, Massachusetts	Other/None
La Mestiza	redirect::Una Mestiza
Category:Geography of Merseyside	Other/None
Category:Buildings and structures in Salem, Massachusetts	C_Location
Ohm meter	redirect::Ohmmeter
Category:Geography of the West Midlands (county)	Other/None
Category:Minden, Louisiana	C_Location
Steve Nichol	redirect::Loose Ends (band)
UTC-07	redirect::UTC−07:00
Signal Hill (Band)	redirect::Signal Hill (band)
Princess Izabela Czartoryska	redirect::Izabela Czartoryska
List of awards and nominations received by John Wayne	redirect::John Wayne#Awards and nominations
Rafal Zielinski	Person
County Route 394 (Erie County, New York)	redirect::List of county routes in Erie County, New York#Routes 301-400
Buckley Bay station	C_Location
County Route 1 (Genesee County, New York)	redirect::List of county routes in Genesee County, New York#County Route 1
Guilty (Album)	redirect::Guilty#Albums
County Route 11 (Genesee County, New York)	redirect::List of county routes in Genesee County, New York#County Route 11
County Route 8 (Genesee County, New York)	redirect::List of county routes in Genesee County, New York#County Route 8
County Route 2 (Genesee County, New York)	redirect::List of county routes in Genesee County, New York#County Route 2
County Route 4 (Genesee County, New York)	redirect::List of county routes in Genesee County, New York#County Route 4
Osgood curve	Other/None
County Route 12 (Genesee County, New York)	redirect::List of county routes in Genesee County, New York#County Route 12
Wikipedia:LONDONNAMES	redirect::Wikipedia:WikiProject London/Naming conventions
County Route 13 (Genesee County, New York)	redirect::List of county routes in Genesee County, New York#County Route 13
County Route 14 (Genesee County, New York)	redirect::List of county routes in Genesee County, New York#County Route 14
County Route 17 (Genesee County, New York)	redirect::List of county routes in Genesee County, New York#County Route 17
County Route 22 (Genesee County, New York)	redirect::List of county routes in Genesee County, New York#County Route 22
County Route 30 (Genesee County, New York)	redirect::List of county routes in Genesee County, New York#County Route 30
St Peter's Square, Hammersmith, London, W6	redirect::St Peter's Square, London
Unknown (2011 film)	Other
County Route 34 (Genesee County, New York)	redirect::List of county routes in Genesee County, New York#County Route 34
County Route 35 (Genesee County, New York)	redirect::List of county routes in Genesee County, New York#County Route 35
County Route 36 (Genesee County, New York)	redirect::List of county routes in Genesee County, New York#County Route 36
County Route 38 (Genesee County, New York)	redirect::List of county routes in Genesee County, New York#County Route 38
County Route 45 (Genesee County, New York)	redirect::List of county routes in Genesee County, New York#County Route 45
County Route 47 (Genesee County, New York)	redirect::List of county routes in Genesee County, New York#County Route 47
Guilty (1997 album)	redirect::Guilty (Hugh Cornwell album)
County Route 69 (Rockland County, New York)	redirect::List of county routes in Rockland County, New York#County Route 69
Midhunam (film)	redirect::Mithunam
Deep Bay station	C_Location
Category:Squares in the London Borough of Hammersmith and Fulham	Other/None
YOTBR	redirect::Year of the Black Rainbow
Dunsmuir station (British Columbia)	A_Location
Plimmerton railway station	A_Location
Big Island Film Festival	Other/None
Qualicum Beach station	A_Location
22 St Peter's Square, Hammersmith, London, W6	redirect::22 St Peter's Square
Golden Honu	redirect::Big Island Film Festival
Category:Natchitoches, Louisiana	C_Location
Four Cops Shot	redirect::Law & Order (season 20)#ep450
