Title	Category
Stranda, Norway	redirect::Stranda
Self destruction	redirect::Self-destructive behavior
Workers' Party of Social Justice	C_Organization
Template:LGV Sud Est	Other/None
Template:Halych Raion	Other/None
SB1070	redirect::Arizona SB 1070
Naturally selena gomez	redirect::Naturally (Selena Gomez & the Scene song)
SB 1070	redirect::Arizona SB 1070
Ultra Mega	redirect::Oficial Fierro
Rule 72	redirect::Rule of 72
Category:American musicians of Japanese descent	C_Person
University of Lesotho	redirect::National University of Lesotho
Fang and Claw	Other
Marina (Polish singer)	Person
Sexy chick	redirect::Sexy Bitch
No Fear Downhill Mountain Biking	Other
Harald Belker	C_Person
Timeline of the 1999 Atlantic hurricane season	Other/None
Oreaster reticulatus	Other/None
Super F1 Circus	redirect::F1 Circus
Template:Memphis, Tennessee weatherbox	Other/None
Template:1999–2000 FA Premier League PFA Team of the Year	Other/None
Louise Henriette Gabrielle de Lorraine	redirect::Louise de Lorraine, Duchess of Bouillon
Buffalo Bill Cody Homestead	Location
Category:Kazakhstani people imprisoned abroad	Other/None
Charles Falkinder	redirect::Bill Falkinder
Louise Henriette Gabrielle de Lorraine-Marsan	redirect::Louise de Lorraine, Duchess of Bouillon
Naturpark Barnim	redirect::Barnim Nature Park
Cordera Eason	A_Person
Avianca (Brazil)	redirect::Avianca Brasil S.A.
Penalty killing	redirect::Short-handed
Avianca (Brazil) destinations	redirect::List of Avianca destinations
United Nations Security Council Resolution 1072	C_Organization
G. Lorne Monkley	redirect::Lorne Monkley
Klaus Wiese	C_Person
Mademoiselle de Marsan	redirect::Louise de Lorraine, Duchess of Bouillon
Lorne H. MacFarlane	redirect::Lorne MacFarlane
The Swordsman in Double Flag Town	redirect::Swordsmen in Double Flag Town
Francis J. MacNeill	redirect::Francis MacNeill
Swordsmen in Double Flag Town	Other
Daniel F. MacNeill	redirect::Daniel MacNeill
Template:2000–01 FA Premier League PFA Team of the Year	Other/None
The eagles	redirect::Eagles (band)
Patrick Trahan	Person
Frederick W. Füger	Person
Thomas Wrigley Grimshaw	Other/None
CMLL Super Viernes (January 2010)	Other
The Webster Boy	Other/None
Swope Art Museum	Location
Gerald Harris (MMA fighter)	redirect::Gerald Harris (fighter)
Category:Mystic River	Other/None
Sheldon Swope Art Museum	redirect::Swope Art Museum
CMLL Super Viernes (February 2010)	Other
Category:American military personnel of Japanese descent	C_Person
Orange Box Engine	redirect::Source (game engine)
CMLL Super Viernes (March 2010)	Other
SX-70	redirect::Polaroid SX-70
Category:Rejected or withdrawn nominees to the United States Executive Cabinet	Other/None
Category:American military personnel of Filipino descent	C_Person
Gerald Harris (American football)	A_Person
Robbie Bina	Person
Æon Flux (comics)	redirect::Æon Flux#Comics
Hungarians in Transylvania	redirect::Hungarians in Romania
Category:African-American military personnel	C_Person
Don't go there	redirect::Taboo
Template:2001–02 FA Premier League PFA Team of the Year	Other/None
Joe & Mac 2: Lost in the Tropics	C_Company
Kuzhambu	Other
Ortgies 7.65mm Semi-Automatic Pistol	redirect::Ortgies Semi-Automatic Pistol
Category:Burials at the Église Saint-Sulpice, Paris	Other/None
Frank Bassen	Other/None
Synaptic tagging	Other/None
Alex Gordey	Person
Ray Fisher (cornerback b.1987)	redirect::Ray Fisher (cornerback)
Æon Flux: the Herodotus File	redirect::Æon Flux#Comics
MD 646	redirect::Maryland Route 646
Sir Thomas Butler, 1st Baronet	Other/None
MD 624	redirect::Maryland Route 624
Computing Centre of the Academy of Sciencies	Other/None
Maltwood Art Museum and Gallery	Other/None
Gerald Harris (American football player)	redirect::Gerald Harris (American football)
Winnold House	Other/None
Brampton Island (Queensland)	redirect::Brampton Island
Category:Canadian rock music	Other/None
Scarlet jungleflame	redirect::Ixora coccinea
U.S. Golf Association	redirect::United States Golf Association
Gerald Harris (disambiguation)	redirect::Gerald Harris
Working Girls (2010 film)	Other
United Nations Security Council Resolution 1073	C_Organization
Psalmody Movement	Other/None
United Nations resolutions concerning Israel	redirect::List of United Nations resolutions concerning Israel
Auquakuh Valles	redirect::Auqakuh Vallis
Free Zone Scientology	redirect::Free Zone (Scientology)
Singing in tongues	redirect::Singing in the Spirit
Robert Bina	redirect::Robbie Bina
Die crack	redirect::Die defect#Die crack
Ethnic groups in Canada	redirect::Ethnic origins of people in Canada
CMLL Super Viernes (April 2010)	Other
Universidad de León	redirect::University of León
Monogamy (film)	Other
