Title	Category
Tenkuu Senki Shurato: Sōsei e no Antō	redirect::Legend of Heavenly Sphere Shurato
Legend of Heavenly Sphere Shurato: Sōsei e no Antō	redirect::Legend of Heavenly Sphere Shurato
Jiangsu Television	C_Location
Daitoryu	redirect::Daitō-ryū Aiki-jūjutsu
Desiré (actor)	redirect::Désiré (baritone)
Raz Cohen	Person
Zhejiang Television	C_Location
CDP-choline	redirect::Citicoline
Saint Senan of Laraghbrine	redirect::Senan of Laraghbrine
List of people who have headed the United States Patent Office	Other/None
CULTURE Magazine	redirect::Culture Magazine
Category:1970 in Fiji	Other/None
Lev Urusov	C_Person
Decree of Dionysopolis	Other/None
UCLA Chabad House	redirect::University of California, Los Angeles#Chabad House
Tropical Storm Omeka	Other
Laser linewidth	Other/None
Wikipedia:WikiProject Computer security	redirect::Wikipedia:WikiProject Computer Security
Teddy duncan	redirect::Good Luck Charlie#Characters
La Pocatiere	redirect::La Pocatière
Wikipedia:Version 1.0 Editorial Team/Roman Curia articles by quality log	Other/None
Isis Current Bibliography	redirect::Isis (journal)
O-phosphocholine	redirect::Phosphocholine
List of townlands of the barony of Bantry in County Cork.	redirect::List of townlands of the barony of Bantry, County Cork
Book:Apollo program	Other/None
G tablet	redirect::ViewSonic G Tablet
King Lincoln Bronzeville Neighborhood Ass'n v. Blackwell	Other
Survivor 22	redirect::Survivor: Redemption Island
List of townlands of the barony of Barretts in County Cork.	redirect::List of townlands of the barony of Barretts
List of townlands of the barony of Barrymore in County Cork.	redirect::List of townlands of the barony of Barrymore
List of townlands of the barony of Bear in County Cork.	redirect::List of townlands of the barony of Bear
List of townlands of the barony of Condons & Clangibbon in County Cork.	redirect::List of townlands of the barony of Condons & Clangibbon
Viewsonic G Tablet	redirect::ViewSonic G Tablet
List of townlands of the barony of Cork in County Cork.	redirect::List of townlands of the barony of Cork
List of townlands of the barony of Courceys in County Cork.	redirect::List of townlands of the barony of Courceys
Chottogram	redirect::Chittagong
List of townlands of the barony of Duhallow in County Cork.	redirect::List of townlands of the barony of Duhallow
List of townlands of the barony of East Carbery (E.D.) in County Cork.	redirect::List of townlands of the barony of East Carbery (East Division)
List of townlands of the barony of East Carbery (W.D.) in County Cork.	redirect::List of townlands of the barony of East Carbery (West Division)
Chottagram	redirect::Chittagong
List of townlands of the barony of East Muskerry in County Cork.	redirect::List of townlands of the barony of East Muskerry
I Just Had Sex	Other
List of townlands of the barony of Fermoy in County Cork.	redirect::List of townlands of the barony of Fermoy
List of townlands of the barony of Ibane and Barryroe in County Cork.	redirect::List of townlands of the barony of Ibane and Barryroe
List of townlands of the barony of Imokilly in County Cork.	redirect::List of townlands of the barony of Imokilly
Chrysalis (sculpture)	A_Location
List of townlands of the barony of Kerrycurrihy in County Cork.	redirect::List of townlands of the barony of Kerrycurrihy
List of townlands of the barony of Kinalea in County Cork.	redirect::List of townlands of the barony of Kinalea
List of townlands of the barony of Kinalmeaky in County Cork.	redirect::List of townlands of the barony of Kinalmeaky
William O'Reilly (MP)	Other/None
Francis J. Crosby	redirect::Fanny Crosby
List of townlands of the barony of Kinnatalloon in County Cork.	redirect::List of townlands of the barony of Kinnatalloon
List of townlands of the barony of Kinsale in County Cork.	redirect::List of townlands of the barony of Kinsale
Viewsonic g tab	redirect::ViewSonic G Tablet
List of townlands of the barony of Orrery and Kilmore in County Cork.	redirect::List of townlands of the barony of Orrery and Kilmore
List of townlands of the barony of West Carbery (E.D.) in County Cork.	redirect::List of townlands of the barony of West Carbery (East Division)
Anthony Parker (Canadian football)	Person
Viewsonic gtab	redirect::ViewSonic G Tablet
Gtab	redirect::ViewSonic G Tablet
List of townlands of the barony of West Carbery (W.D.) in County Cork.	redirect::List of townlands of the barony of West Carbery (West Division)
List of townlands of the barony of West Muskerry in County Cork.	redirect::List of townlands of the barony of West Muskerry
Martin Van Buren Montgomery	redirect::Martin V. Montgomery
G tab	redirect::ViewSonic G Tablet
Action Replay Max	redirect::Action Replay
Metropolitan West Side Elevated	redirect::Metropolitan West Side Elevated Railroad
Susie Frances Harrison	Person
Viewsonic gtablet	redirect::ViewSonic G Tablet
Marcel Bouteron	C_Person
Seranus	redirect::Susie Frances Harrison
Scindia (Shinde) Ghat	redirect::Scindia Ghat
Engineering Index Monthly	redirect::Ei Compendex
Wikipedia:Version 1.0 Editorial Team/University of the Philippines articles by quality log	Other/None
André Billy	C_Person
Nathan Coehoorn	Person
Akornion	Other/None
Jenny Rohn	redirect::Jennifer Rohn
Léon Ouroussoff	redirect::Lev Urusov
Judson Birza	redirect::Jud Birza
GTablet	redirect::ViewSonic G Tablet
Luanti Huchuquan	redirect::Huchuquan
Unchained (Law & Order: Criminal Intent episode)	redirect::Law & Order: Criminal Intent (season 5)
Suzuki Choinori	Other
Christopher Glombard	Person
King Lincoln Bronzeville Neighborhood Association v. Blackwell	redirect::King Lincoln Bronzeville Neighborhood Ass'n v. Blackwell
Castle (television show)	redirect::Castle (TV series)
Template:WP Animation	redirect::Template:WikiProject Animation
Unchained (Thor album)	redirect::Unchained (EP)
Virus Quantification	redirect::Virus quantification
William O'Reilly (educator)	C_Person
Cumulative Bibliography	redirect::Isis (journal)#Isis Current Bibliography
Maizuru (train)	Other
Pug Vaughan	Person
Cormac mac Art O Melaghlain	redirect::Cormac mac Art Ó Melaghlain
Wikipedia:Peer review/London Underground A60 and A62 stock/archive1	Other/None
Vacancy (Law & Order: Criminal Intent episode)	redirect::Law & Order: Criminal Intent (season 5)
Élisabeth de Haulteterre	Other/None
Herbert Hunt	C_Person
Template:Dynkin2	Other/None
Template:Université Laval	Other/None
Valdemar of Denmark (1209-1231)	redirect::Valdemar the Young
