Title	Category
Aripiprazole	Other/None
Intelligent traffic system	redirect::Intelligent transportation system
George Bingham, 3rd Earl of Lucan	Person
Ethmoid bone	Other
Nure	Location
Scalars	redirect::Scalar
Contragate	redirect::Iran–Contra affair
Internet site	redirect::website
Irangate	redirect::Iran–Contra affair
Ecclesia Gnostica	Other
Os ethmoidale	redirect::Ethmoid bone
Gnostic Society	Organization
Johnson	Other
Sex-toy	redirect::Sex toy
Wernicke–Korsakoff syndrome	Other
Noah Wyle	Person
Ed McBain	Person
Eugenio Montale	Person
Julia (women of the Julii Caesares)	Other/None
Episiotomy	Other
Address resolution protocol	redirect::Address Resolution Protocol
American wire gauge	Other/None
Pannonian Plain	redirect::Pannonian Basin
Panonian plain	redirect::Pannonian Basin
War powers act (US law)	redirect::War Powers Resolution
War powers resolution (US law)	redirect::War_Powers_Resolution
Kennel Club (UK)	redirect::The Kennel Club
Swiss guard	redirect::Swiss Guard
Francis I, King of France	redirect::Francis I of France
Mehdi Ghezali	Person
Mehdi Mohammed Ghezali	redirect::Mehdi Ghezali
Doubleplusungood	redirect::Newspeak#Prefixes
Tissa	Other/None
Theiss river	redirect::Tisza
Storsien	C_Location
Löbau-Zittau	Location
Guys And Dolls	redirect::Guys and Dolls
87th Precinct	Other
List of Roman battles	redirect::List of Roman wars and battles
Distributed Language Translation	Other/None
Lists of endangered languages	Other/None
Bernhard Bolzano	redirect::Bernard_Bolzano
Common year	Other/None
Renaissance art	Other/None
René Cassin	Person
Early Renaissance paintings	redirect::Renaissance art
Kohlberg, Kravis, and Roberts	redirect::Kohlberg Kravis Roberts
Leap year starting on Sunday	Other/None
Dominion (angel)	redirect::Christian angelology#Dominions or Lordships
Straits of Messina	redirect::Strait of Messina
Pregnancy test	Other/None
Curt Cannon	redirect::Ed McBain
Fog of War	redirect::Fog of war
Albert Luthuli	Person
2002 in art	Other/None
Robert Campin	Other/None
Valsalva maneuver	Other
Early Renaissance painter	redirect::Renaissance art
Early Dutch Renaissance	redirect::Dutch and Flemish Renaissance painting
Andrew Eldritch	Person
Obesity hypoventilation syndrome	Other
Von Willebrand disease	Other
Doktor Avalanche	redirect::The Sisters of Mercy#Doktor Avalanche
Korotkoff sounds	Other/None
Common year starting on Tuesday	Other/None
Mammary gland	Other
Data rate	Other/None
Transfer rate	redirect::Bit rate
Major-General	redirect::Major general
Prince of Darkness (film)	C_Organization
Hirschsprung's disease	Other
Supramolecular assemblies	redirect::Supramolecular assembly
Life pornography	redirect::Berlin Nights Grand Delusions
Life Pornography	redirect::Berlin Nights Grand Delusions
Order of the Bath	Other
Knight Commander of the Bath	redirect::Order_of_the_Bath
Megaptera novaeangliae	redirect::Humpback whale
Tinsley Viaduct	Location
Taxan	Company
Afghan Constitution Commission	Other/None
Asparuh of Bulgaria	A_Person
Reverse domain hijacking	Other/None
Reverse domain name hijacking	redirect::Reverse domain hijacking
Girlfriend in a Coma (novel)	Other
Nicolas Oudinot	Person
Aberdeen FC	redirect::Aberdeen F.C.
Sandton	Location
Pen and Teller	redirect::Penn & Teller
Hovertank 3D	Other
Catacomb 3-D	Other
Peter Struck (politician)	Person
Acclaim Entertainment	Company
Reagan administration	redirect::Presidency of Ronald Reagan
Sphenoid bone	Other
Translation (mathematics)	redirect::Translation (geometry)
Nutrasweet	redirect::NutraSweet
Positive semi-definite	redirect::Positive semidefinite
MapQuest	Company
Mapquest	redirect::MapQuest
Opodeldoc	Other/None
