Title	Category
Category:Buildings and structures in Yerevan	Other/None
2011 Australian motorcycle Grand Prix	C_Organization
Kasper Cole	redirect::White Tiger (Kasper Cole)
SDS Sigma 5	redirect::SDS Sigma series
L'an 2005 (album)	redirect::Dalida discography
2011 Australian Carrera Cup Championship	Other/None
Sin: The Movie	Other
2011 Malaysian motorcycle Grand Prix	C_Organization
John F. Ryan	Other/None
Trevose Manor	redirect::Growden Mansion
Pendulum Drift	Other
Ktimene	redirect::Ctimene
Wikipedia:Featured article candidates/Rivadavia class battleship/archive1	redirect::Wikipedia:Featured article candidates/Rivadavia-class battleship/archive1
Toronto FC 2011	redirect::2011 Toronto FC season
Hibbertia australis	redirect::Hibbertia riparia
Martín Fierro award	redirect::Martín Fierro Awards
Template:Indiana statewide political officials	Other/None
2011 Valencian Community motorcycle Grand Prix	C_Organization
List of hereditary peers in the House of Lords by virtue of a life peerage	Other/None
Hibbertia stricta	redirect::Hibbertia riparia
Black Country Communion 2	Other
List of major power stations in Xinjiang	C_Location
Erect Guinea-flower	redirect::Hibbertia riparia
William D. Cardwell	Other/None
Vickers light machine gun	redirect::Vickers–Berthier
N00 (disambiguation)	redirect::N00
Watkins Overton	A_Person
Acoustic (Second Coming EP)	redirect::13 (Second Coming album)
Erect guinea flower	redirect::Hibbertia riparia
List of plantations in Virginia	Other/None
Frederick Ross (disambiguation)	redirect::Frederick Ross
Policy or practice	redirect::Policy
Les Gitans (album)	redirect::Les gitans
The Wereling Trilogy	Other
Richard Evelyn Byrd Sr.	Person
Members of the New South Wales Legislative Assembly, 2011–2015	C_Person
Grete Margaret Schüller	Person
WKHF	A_Location
Edwin P. Cox	A_Person
NO3−	redirect::Nitrate
Harry R. Houston	C_Person
NO2−	redirect::Nitrite
Richard L. Brewer Jr.	Person
Ian Partridge	C_Person
Portal:London transport/Selected biographies	Other/None
FC Pärnu Linnameeskond	redirect::Pärnu Linnameeskond
Thomas W. Ozlin	C_Person
List of mortar carriers	Other/None
Practices	redirect::Practice
Courageous Mr. Penn	redirect::Penn of Pennsylvania
J. Sinclair Brown	C_Person
George Ziegenfuss	C_Person
Joseph Prentis	C_Person
Lewis Bridge (Keya Paha River)	Location
Portal:London transport/Selected biography/February 2010	redirect::Portal:London transport/Selected biographies/1
Jenny Fromdabloc	Other
John L. Cashin Jr.	C_Person
89th Cavalry Regiment	Other
Ca(H2PO4)2	redirect::Monocalcium phosphate
Portal:London transport/Selected biography/March 2010	redirect::Portal:London transport/Selected biographies/2
Lewis Bridge (Nebraska and South Dakota)	redirect::Lewis Bridge (Keya Paha River)
Gerasimova	redirect::Gerasimov
Faroe Is.	redirect::Faroe Islands
Portal:London transport/Selected biography/April 2010	redirect::Portal:London transport/Selected biographies/3
Ragi (Sikhism)	Other/None
Portal:London transport/Selected biography/May 2010	redirect::Portal:London transport/Selected biographies/4
Juan De Nova Island	redirect::Juan de Nova Island
Garde-moi la dernière danse (album)	redirect::Dalida internationale
Portal:London transport/Selected biography/June 2010	redirect::Portal:London transport/Selected biographies/5
Hollingworth Magniac	Other/None
Garde-moi la derniere danse	redirect::Dalida internationale
Dennis Arundell	C_Person
Quota sample	redirect::Quota sampling
Portal:London transport/Selected biography/July 2010	redirect::Portal:London transport/Selected biographies/6
'Pimpernel' Smith	"redirect::""Pimpernel"" Smith"
List of Secret Mountain Fort Awesome episodes	redirect::Secret Mountain Fort Awesome#Episodes
Baoshan Township	redirect::Baoshan
Portal:London transport/Selected biography/August 2010	redirect::Portal:London transport/Selected biographies/7
Template:Airports in Azerbaijan	C_Location
Vow of Silence	redirect::Vow of silence
Portal:London transport/Selected biography/September 2010	redirect::Portal:London transport/Selected biographies/8
Ngomi	redirect::Music of Mozambique
The Economic Region of Production	redirect::Economic region of production
Category:1952 establishments in Australia	Other/None
Railway Sans	redirect::Johnston (typeface)
Charles Carson (actor)	Person
List of autocannon	Other/None
Lewis County Courthouse (Tennessee)	Location
VNPA	redirect::Victorian National Parks Association
Khalifa Hifter	redirect::Khalifa Haftar
241543903	redirect::David_Horvitz
Portal:London transport/Selected biography/October 2010	redirect::Portal:London transport/Selected biographies/9
Wikipedia:WikiProject Spam/Local/forgetechbd.com	Other/None
List of major power stations in the Tibet Autonomous Region	C_Location
Portal:London transport/Selected biography/November 2010	redirect::Portal:London transport/Selected biographies/10
Wikipedia:WikiProject Spam/Local/immersive-worlds-tool-ranking.grouply.com	Other/None
Tara Theatre	C_Location
Portal:London transport/Selected biography/December 2010	redirect::Portal:London transport/Selected biographies/11
Template:Airports in Georgia (country)	C_Location
Parakseno sinesthima	Other
