Title	Category
Kaiserbrundl Sauna	redirect::Central Bathhouse Vienna
Vahnabad Rural District	Location
Uli Spieß	C_Person
Dobrá Voda (disambiguation)	redirect::Dobrá Voda
Kaiserbruendl Sauna	redirect::Central Bathhouse Vienna
2011 Super Copa León México	redirect::2011 Super Copa Telcel
Dobra Voda (Peak)	redirect::Dobra Voda (mountain)
C'est La Vie (Martin Solveig album)	redirect::C'est la Vie (Martin Solveig album)
Edie Parker (artist)	C_Person
Meymanat Rural District	Location
Salehabad Rural District (Tehran Province)	Location
Better Than Ezra discography	Other
Ivano Edalini	Person
Julius Reinhardt (footballer)	Person
Category:Lists of Scheduled Castes by state	Other/None
Hans-Joachim Kappis	redirect::List of Knight's Cross of the Iron Cross recipients (Ka–Km)
Template:Sports governing bodies in Denmark	Other/None
Witman Wits V	redirect::Wittman V-Witt
On the Personality Cult and Its Consequences	redirect::On the Cult of Personality and Its Consequences
Recognition of Native American sacred sites in the United States	C_Organization
Liverpool Medical Students Society	Other
Template:2012 WNBA draft	Other/None
Frédéric Covili	C_Person
James Hutchison Cockburn	redirect::James Cockburn (minister)
2012 Super Copa Telcel	Other/None
CP Goya Almería	Other
Austin Wintory	Person
Gerhard Pfaffenbichler	C_Person
Digital Access Signaling System 1	redirect::Digital Access Signalling System 1
2012 Kyrgyzstan League	Other
Villa Myosótis	Other/None
Digital Access Signaling System 2	redirect::Digital Access Signalling System 2
Adaran, Tehran	Location
Bartl Gensbichler	C_Person
Funnyback	redirect::United States one-dollar bill#Small size notes
Category:Images of Sting (musician)	C_Person
Funnybacks	redirect::United States one-dollar bill#Small size notes
United States cyber-diplomacy	Other/None
Aderan	redirect::Adaran
Category:Sting (musician) album covers	C_Person
Strange Flesh	Other/None
Emamzadeh Baqer	Location
Deh Hasan, Tehran	Location
Wikipedia:Peer review/Curt Roberts/archive1	Other/None
Gerhard Wagner (Nazi physician)	redirect::Gerhard Wagner (physician)
Kazemabad, Tehran	Location
Fastcompany.com	redirect::Fast Company
2010–11 Stirling Albion F.C. season	C_Person
Lynx (grooming product)	redirect::Axe (brand)
Generation Flux	redirect::Millennials
Poster Museum at Wilanow	redirect::Poster Museum, Wilanów
Anjemabad	Location
Michael John Hunt	Person
Template:Cork NHL Team 1974	Other/None
Elviz	redirect::Anjemabad
Franco Bieler	C_Person
Asgharabad, Tehran	Location
Lynx (brand)	redirect::Lynx (disambiguation)
Suppression of the (1750-1773) Jesuits	redirect::Suppression of the Society of Jesus
Navheh Division	Location
Hesar Mehtar, Robat Karim	Location
Engelhard Pargätzi	C_Person
Hoseynabad-e Yangejeh	Location
Hoseynabad-e Yangecheh	redirect::Hoseynabad-e Yangejeh
Laqeh	Location
History of the (pre-1750) Jesuits	redirect::Society_of_Jesus#History
Our Last Night (Better Than Ezra song)	Other
Yaqeh	redirect::Laqeh
Keygavar	Location
1966 College Baseball All-America Team	Other/None
NIRC	redirect::Yeshivas Ner Yisroel
Keykavar	redirect::Keygavar
Kikavar	redirect::Keygavar
Kikavor	redirect::Keygavar
History of the (1773-1814) Jesuits	redirect::Society_of_Jesus#History
Manjilabad	Location
French frigate Charente (1793)	redirect::French frigate Capricieuse (1787)
Peyghambar	Location
Mohammadabad-e Peyghambar	redirect::Peyghambar
Poems (poetry by Golding)	redirect::Poems (Golding collection)
Philippe Roux	C_Person
Parandak, Tehran	Location
Shahrak-e Parandak	redirect::Parandak, Tehran
Truth and Purpose	Other
Sefidar, Tehran	Location
A Moment in Life That's Right	Other
Shahrabad-e Ilat	Location
BASIC-256	redirect::Basic-256
Hesarabad	Location
Hesarabad-e Ilat	redirect::Shahrabad-e Ilat
René Berthod	C_Person
Franz Konrad (disambiguation)	redirect::Franz Konrad
Shahr-e Jadid-e Parand	Location
Shahrak-ye Yarnedak	Location
Aliabad, Robat Karim	Location
Hakimabad, Tehran	Location
Mare Chicose	C_Location
Adolf Rösti	C_Person
Now Deh, Robat Karim	Location
Retinal waves	Other/None
