Title	Category
Draconian Times MMXI	redirect::Draconian Times
Adolphe Lumanu Mulenda Bwana N’Sefu	redirect::Adolphe Lumanu
China Disabled Persons’ Federation	redirect::China Disabled Persons' Federation
Winds of Change (magazine)	redirect::American Indian Science and Engineering Society#Winds of Change magazine
Category:1999 establishments in Tibet	Other/None
Order of the Two Rivers	C_Location
Jacques La Degaillerie	redirect::Jacques Ladègaillerie
Category:1990s in Tibet	Other/None
Category:1990s establishments in Tibet	Other/None
Category:Transit agencies in Oregon	Other/None
Characidium fasciatum	Other/None
Lex Baillie	Person
Category:Transit agencies in Pennsylvania	Other/None
Category:1999 establishments in Saudi Arabia	Other/None
Category:1990s establishments in Saudi Arabia	Other/None
EMCare	redirect::Embase
Category:Films about amnesia	Other/None
Member state of the EU	redirect::Member state of the European Union
European Union states	redirect::Member state of the European Union
European Union state	redirect::Member state of the European Union
Member of the EU	redirect::Member state of the European Union
Category:Transit agencies in Alabama	Other/None
Amanda Palmer & The Grand Theft Orchestra	redirect::Amanda Palmer
Myles Morin	C_Person
Myles Leslie Morin	redirect::Myles Morin
Vicky Horner	Person
Kōtetsuyama Keisuke	redirect::Itai Keisuke
Category:Transit agencies in Arizona	Other/None
Lord Alness	redirect::Robert Munro, 1st Baron Alness
Dāsh Kasan, Isfahan	redirect::Dāshkasan, Isfahan
Kotetsuyama Keisuke	redirect::Itai Keisuke
2003 Central American Championships in Athletics	Other
Category:Recipients of the Order of Al Rafidain	Other/None
Serrasalmus neveriensis	Other/None
John Wesley Wright	Person
Constitution of Somalia	Other/None
Sassarese dialect	redirect::Sassarese language
Abstract prime number theorem	redirect::Abstract analytic number theory#Methods and techniques
Category:Transit agencies in Ohio	Other/None
Roy Baines	Person
Lief Nielsen	redirect::Leif Nielsen
Pseudochazara baldiva	Other/None
One nation	redirect::One Nation
Glasgow Marathon	redirect::Great Scottish Run
Category:Transit agencies in West Virginia	Other/None
Scottish People's Marathon	redirect::Great Scottish Run
Hidalgo (Sherry)	redirect::Hidalgo (sherry)
Category:Chester F.C. managers	Other/None
Category:Ambassadors of Armenia to the United Kingdom	C_Person
Wertz's Covered Bridge	Location
Category:Ambassadors of Armenia to the United States	C_Person
Government Investment Unit of Indonesia	Other/None
Pusat Investasi Pemerintah	redirect::Government Investment Unit of Indonesia
Category:Transit agencies in Arkansas	Other/None
Michela Brunelli	Person
Andrea Belotti	Person
Building Maintenance Unit	redirect::Building maintenance unit
RMIT Global Cities Research Institute	Other/None
Eucera	Other/None
Category:Transit agencies in Alaska	Other/None
Category:Women's roller hockey	Other/None
Category:Transit agencies in Colorado	Other/None
Category:Impact event films	C_Organization
Motif (band)	Person
Rodaidh McDonald	Person
Johno Ford	redirect::Johnathon Ford
File:2012 Shanghai Masters poster.jpg	Other/None
Play More	C_Location
Order of Francesc Skarina	redirect::Order of Francysk Skaryna
Category:Zimbabwean newspaper editors	Other/None
Category:Zimbabwean editors	Other/None
Kutz's Mill Bridge	Location
Arge melanochra	redirect::Arge melanochroa
Pseudochazara beroe	Other/None
Category:Transit agencies in Connecticut	Other/None
Yitzhak Tshuva	Person
Tiktik: The Aswang Chronicles (film)	redirect::Tiktik: The Aswang Chronicles
Vital Maria Gonçalves de Oliveira	Person
Antônio de Macedo Costa	C_Organization
Norbert Fuhr	C_Person
Binarism	redirect::Gender binary
Pseudochazara droshica	Other/None
1978 Yugoslavian motorcycle Grand Prix	Other
Italian Paralympic Committee	C_Organization
Donnelley	redirect::Donnelly (surname)
Category:Impact event novels	C_Organization
Sinem Saban	C_Person
Jon Finlayson	Person
Category:Transit agencies in Delaware	Other/None
Pleasantville Bridge	Location
Gavin Rose	Person
CMLL 79th Anniversary Show	C_Organization
Template:Latest preview software release/Mozilla Firefox 3.5	Other/None
The Saddle Buster	Other
Category:Transit agencies in Florida	Other/None
2012–13 LEN Champions League	Other
Freighters of Destiny	Other
Brazilian Lay Association crisis	redirect::Religious Question
Template:Latest preview software release/Mozilla Firefox 3	Other/None
Non-binary discrimination	redirect::Discrimination against non-binary people
