Title	Category
Template:User North Jersey	Other/None
ΕΠΟΓΔΟΩΝ	redirect::Major second#Epogdoon
Ręce Boga	redirect::Slavic Native Faith
ΔΙΑΠΕΝΤΕ	redirect::Perfect fifth
ΔΙΑΠΑΣΩΝ	redirect::Octave
Omar Butti	redirect::Dina Butti
Wikipedia:VE/KP	redirect::Wikipedia:visualEditor/Known problems
ΔΙΑΤΕΣΣΑΡΩΝ	redirect::Perfect fourth
BÉPO	Other/None
Alexandru Cristian Popovici	redirect::Alexandru Adrian Popovici
Category:Wikipedians in North Jersey	Other/None
Danielskuil	redirect::Daniëlskuil
Wikipedia:Route diagram template/BS-anleitungP/header/doc	Other/None
Team Apatow	redirect::Judd Apatow#Film
Barium acetylacetonate	Other/None
Saidabad Rural District (Pardis County)	Location
FC Kapstadt	redirect::F.C. Cape Town
Flintholmen	Other/None
Template:According to	redirect::Template:According to whom
Wikipedia:Route diagram template/BS-anleitungP/doc	Other/None
Amy Hood	Person
Daryl Henley	redirect::Darryl Henley
Wikipedia:Templates for discussion/Log/2013 July 18	Other/None
Ipoch Bogátradvány	Other
Wikipedia:RDT/BSaM/h	redirect::Wikipedia:Route diagram template/BS-anleitungM/header
Young and Beautiful (Lana Del Rey)	redirect::Young and Beautiful (Lana Del Rey song)
Template:Basketballbox/doc	Other/None
FUL MA 30 Graffiti	Other
Noburô Ôfuji	redirect::Noburō_Ōfuji
Shilin Zhu	redirect::Zhu Shilin
Castilleja pumila	Other/None
Purple flowers	redirect::Purple#Plants_and_flowers
Wikipedia:RDT/BSaM	redirect::Wikipedia:Route diagram template/BS-anleitungM
Franco Quartermaine	redirect::Franco (General Hospital)
Rf module	redirect::RF module
Fachschule für Ultraleicht und Motorflug MA 30 Graffiti	redirect::FUL MA 30 Graffiti
Church of All Saints, Aisholt	Location
Kajirô Yamamoto	redirect::Kajirō_Yamamoto
Egypt's Future Party	redirect::Egypt Party
Jajrud District	Other/None
MA-30	redirect::MA 30
Herman Smith (gridiron football)	Person
Shipping in Gibraltar	Other/None
2001 World Archery Championships - Women's Team Compound	Other/None
2001 World Archery Championships - Men's Team Compound	Other/None
Wikipedia:Articles for creation/Bristol Alliance of Companies	redirect::Bristol Alliance of Companies
Alabat Island Agta language	redirect::Inagta Alabat language
Lancetilla del Páramo	redirect::Castilleja pumila
Manide	redirect::Manide language
Wikipedia:A/CP	redirect::Wikipedia:Arbitration/Current
Lancetilla del Paramo	redirect::Castilleja pumila
Category:Pardis County	Other/None
Brann Boardinghouse	Location
Category:Populated places in Pardis County	C_Location
Kill the Wolf (Matt Berry album)	Other
Dylan Sprayberry	Person
Jason Regier	A_Person
Cerium acetylacetonate	Other/None
Wikipedia:WikiProject Spam/LinkReports/sammisanchez.com	Other/None
The Bangerz	Person
Category:Santa Rosa Mountains (California)	C_Location
Villarceau's theorem	redirect::Villarceau circles
Tenshin Zenki Reb Anderson	redirect::Reb Anderson
Until the Time Is Through (Five song)	redirect::Until the Time Is Through
Category:Chilean art critics	Other/None
Wikipedia:WikiProject Spam/Local/maratech.ca	Other/None
Category:San Jacinto Mountains	C_Location
Gayatri Rajapatni	Person
Up Tight	redirect::Uptight
Eksteenfontein	Location
Uptight (disambiguation)	redirect::Uptight
Category:21st century in New York City	Other/None
Narcea	redirect::Narcea (river)
H. C. Andersens Boulevard	Other/None
Narcea River	redirect::Narcea (river)
Nicholas Springer	Person
Category:Centuries in New York City	Other/None
Lekkersing	Location
Connie Gilchrist, Countess of Orkney	Person
Use Me (song)	redirect::Use Me
Category:21st century in Los Angeles	Other/None
Category:Centuries in Los Angeles	Other/None
Category:Local Nature Reserves on the Isle of Wight	Other/None
Ensign (United States)	redirect::Ensign (rank)#United States
Lieutenant, Junior Grade (United States)	redirect::Lieutenant (junior grade)
Roald Municipality	redirect::Vigra
Seth McBride	A_Person
Honingfontein	Location
Don 3 (2013 film)	redirect::Don (franchise)
Abridged Chronicles of Đại Việt	redirect::Đại Việt sử lược
Category:21st century in Chicago	Other/None
Category:Centuries in Chicago	Other/None
Uzu (Porno Graffitti song)	redirect::Uzu (song)
Category:Local Nature Reserves in South Yorkshire	Other/None
Template:Did you know nominations/Chris Holtmann	Other/None
Cayuga and Susquehanna Railroad	Other
Abbreviated Annals of Đại Việt	redirect::Đại Việt sử lược
Complete Annals of Đại Việt	redirect::Đại Việt sử ký toàn thư
Disciplina clericalis	redirect::Disciplina Clericalis
Wikipedia:RDT/BSaU	redirect::Wikipedia:Route diagram template/BS-anleitungU
