Title	Category
Foster Air Force Base	A_Location
Big grey man	redirect::Am Fear Liath Mòr
Abby aldrich	redirect::Abby Aldrich Rockefeller
Zuchequon	redirect::Henry_Kuttner_deities#Zushakon
Wikipedia:Complaints	redirect::Wikipedia:Village pump
Torino Palavela	Location
Mad About the Boy	Other
Shayne Breuer	Person
Parantaka I	Person
Metropolitan statistical areas of the United States by income	redirect::List of United States metropolitan areas by per capita income
Subcontrabass clarinet	redirect::Contrabass clarinet#Subcontrabass
Template:User Mars	Other/None
Spike train	redirect::Action potential
Category:The Sins of Thy Beloved albums	Other/None
Arundel (UK Parliament constituency)	Other
Eclavdra	redirect::List of Greyhawk characters#Eclavdra
Andrew Martinez	Person
Contemporary Art Museum Saint Louis	redirect::Contemporary Art Museum St. Louis
Template:User Indian politics	Other/None
Vancouver VooDoo	Other
Philadelphia music	redirect::Music of Philadelphia
Philadelphia music scene	redirect::Music of Philadelphia
Price Revolution	redirect::Price revolution
Invisible plane	Other
Philly music scene	redirect::Music of Philadelphia
Music of Philadelphia, Pennsylvania	redirect::Music of Philadelphia
Co-cola	redirect::Coca-Cola
G.R.S. mead	redirect::G. R. S. Mead
G.r.s. mead	redirect::G. R. S. Mead
Shopping channel	C_Company
Turgay (river)	Location
Turgay	Other/None
Heinrich Johann Nepomuk von Crantz	Person
Les Misèrables	redirect::Les Misérables
Star trek book	redirect::List of Star Trek novels
KUT	A_Location
Star Trek video	redirect::star Trek
Elliptical machine	redirect::Elliptical trainer
Dodge Cove	Location
Triphone	Other/None
GTZ	redirect::Deutsche Gesellschaft für Internationale Zusammenarbeit
Government House (Nova Scotia)	A_Location
Magic lasso	redirect::Lasso of Truth
Southern Expressway (Adelaide)	redirect::Southern Expressway (South Australia)
List of Costa Rican Newspapers and Magazines	redirect::List of newspapers in Costa Rica
Bud Abell	Person
Susette La Flesche	Person
Pomme de Terre River (Missouri)	Location
Heckler & Koch BASR	redirect::Heckler & Koch
Elizabethan Club	Other/None
Little Pomme de Terre River	redirect::Pomme de Terre River (Missouri)
.300 Winchester	redirect::.300 Winchester Magnum
Inaugural Winter Games	redirect::1924 Winter Olympics
Ray Abruzzese	Person
Holy Family High School (Broomfield, Colorado)	A_Location
Ingushis	redirect::Ingush people
Deutsche Gesellschaft für Internationale Zusammenarbeit	Organization
Octocontralto clarinet	redirect::Contrabass clarinet
Ken Adamson	Person
Coca-colas	redirect::Coca-Cola
Contralto clarinet	redirect::Contrabass clarinet
Sir William Mackinnon, 1st Baronet	Person
List of highest-income ZIP Code Tabulation Areas in the United States	Other/None
First Aid for Bleeding	redirect::First aid
Mariana Lakes	redirect::Mariana Lake, Alberta
Cokes	redirect::Coke
Conversion calculations	redirect::Dimensional analysis
2nd Battalion, 2nd Marines	Other
List of Business Interstates	redirect::List of business routes of the Interstate Highway System
Sydeshows	redirect::Sideshow (automobile exhibition)
Brownie mix	redirect::Chocolate brownie
2ndBn 2ndMar	redirect::2nd Battalion, 2nd Marines
Ben Agajanian	Person
Cola de mono	Other/None
Monkey's tail	redirect::cola de mono
Muffin mix	redirect::Muffin
Lockheed Aircraft Company	redirect::Lockheed Corporation
Computer fan	Other/None
Mediaone	redirect::MediaOne
Calgary Cannons	Other
Kolomoki Mounds	Location
Broken Star	Other
Vet's office	redirect::Veterinarian
The National Football League on NBC	redirect::NFL on NBC
Sixlets	Other/None
Half-Life 2: Aftermath	redirect::Half-Life 2: Episode One
Shin'yō-class suicide motorboat	Other
Ira Basen	C_Person
Michael Brennan (field hockey)	C_Person
Harry S. Truman Reservoir	redirect::Truman Reservoir
Zee Cine Award for Best Actor in a Supporting Role – Female	C_Person
Bach cantatas	redirect::List of Bach cantatas
Harry S. Truman Dam	redirect::Truman Reservoir
Dallara Automobili	redirect::Dallara
Algebra of Sets	redirect::Algebra of sets
Holy Family High School (Mumbai)	Other
Back To Life	redirect::Back to Life
Sarah Abitbol	Person
Biblical magi	redirect::biblical Magi
WDTW (AM)	A_Location
