Title	Category
Key West No. 70, Saskatchewan	redirect::Rural Municipality of Key West No. 70
Keys No. 303, Saskatchewan	redirect::Rural Municipality of Keys No. 303
Kindersley No. 290, Saskatchewan	redirect::Rural Municipality of Kindersley No. 290
King George No. 256, Saskatchewan	redirect::Rural Municipality of King George No. 256
Kingsley No. 124, Saskatchewan	redirect::Rural Municipality of Kingsley No. 124
Kinistino No. 459, Saskatchewan	redirect::Rural Municipality of Kinistino No. 459
Lac Pelletier No. 107, Saskatchewan	redirect::Rural Municipality of Lac Pelletier No. 107
Lacadena No. 228, Saskatchewan	redirect::Rural Municipality of Lacadena No. 228
Laird No. 404, Saskatchewan	redirect::Rural Municipality of Laird No. 404
Lajord No. 128, Saskatchewan	redirect::Rural Municipality of Lajord No. 128
Lake Alma No. 8, Saskatchewan	redirect::Rural Municipality of Lake Alma No. 8
Variable extent	redirect::Variable (computer science)#SCOPE-AND-EXTENT
Lake Johnston No. 102, Saskatchewan	redirect::Rural Municipality of Lake Johnston No. 102
Lake Lenore No. 399, Saskatchewan	redirect::Rural Municipality of Lake Lenore No. 399
Lake of the Rivers No. 72, Saskatchewan	redirect::Rural Municipality of Lake of the Rivers No. 72
Lakeland No. 521, Saskatchewan	redirect::District of Lakeland No. 521
Lakeside No. 338, Saskatchewan	redirect::Rural Municipality of Lakeside No. 338
Trophies (Drake song)	redirect::Trophies (song)
Lakeview No. 337, Saskatchewan	redirect::Rural Municipality of Lakeview No. 337
Langenburg No. 181, Saskatchewan	redirect::Rural Municipality of Langenburg No. 181
Last Mountain Valley No. 250, Saskatchewan	redirect::Rural Municipality of Last Mountain Valley No. 250
Laurier No. 38, Saskatchewan	redirect::Rural Municipality of Laurier No. 38
Lawtonia No. 135, Saskatchewan	redirect::Rural Municipality of Lawtonia No. 135
Leask No. 464, Saskatchewan	redirect::Rural Municipality of Leask No. 464
Sook (Korean name)	Other
Leroy No. 339, Saskatchewan	redirect::Rural Municipality of Leroy No. 339
Lipton No. 217, Saskatchewan	redirect::Rural Municipality of Lipton No. 217
Livingston No. 331, Saskatchewan	redirect::Rural Municipality of Livingston No. 331
Kuchkabal	Other/None
Local variables, recursion and reentrancy	redirect::Subroutine#LVRR
Lomond No. 37, Saskatchewan	redirect::Rural Municipality of Lomond No. 37
Lone Tree No. 18, Saskatchewan	redirect::Rural Municipality of Lone Tree No. 18
Longlaketon No. 219, Saskatchewan	redirect::Rural Municipality of Longlaketon No. 219
Loon Lake No. 561, Saskatchewan	redirect::Rural Municipality of Loon Lake No. 561
Loreburn No. 254, Saskatchewan	redirect::Rural Municipality of Loreburn No. 254
Lost River No. 313, Saskatchewan	redirect::Rural Municipality of Lost River No. 313
Gotland University College	redirect::Campus Gotland
Space Age Whiz Kids (song)	C_Person
Lumsden No. 189, Saskatchewan	redirect::Rural Municipality of Lumsden No. 189
Manitou Lake No. 442, Saskatchewan	redirect::Rural Municipality of Manitou Lake No. 442
This Is Fake DIY	redirect::DIY (magazine)
Mankota No. 45, Saskatchewan	redirect::Rural Municipality of Mankota No. 45
Maple Bush No. 224, Saskatchewan	redirect::Rural Municipality of Maple Bush No. 224
Metropolitan Cross-Town Railway	redirect::Metropolitan Crosstown Line
Maple Creek No. 111, Saskatchewan	redirect::Rural Municipality of Maple Creek No. 111
Mariposa No. 350, Saskatchewan	redirect::Rural Municipality of Mariposa No. 350
Marquis No. 191, Saskatchewan	redirect::Rural Municipality of Marquis No. 191
Federal Fire Prevention and Control Act of 1974	Other
Marriott No. 317, Saskatchewan	redirect::Rural Municipality of Marriott No. 317
Martin No. 122, Saskatchewan	redirect::Rural Municipality of Martin No. 122
Maryfield No. 91, Saskatchewan	redirect::Rural Municipality of Maryfield No. 91
Mayfield No. 406, Saskatchewan	redirect::Rural Municipality of Mayfield No. 406
McCraney No. 282, Saskatchewan	redirect::Rural Municipality of McCraney No. 282
McKillop No. 220, Saskatchewan	redirect::Rural Municipality of McKillop No. 220
McLeod No. 185, Saskatchewan	redirect::Rural Municipality of McLeod No. 185
Meadow Lake No. 588, Saskatchewan	redirect::Rural Municipality of Meadow Lake No. 588
Medstead No. 497, Saskatchewan	redirect::Rural Municipality of Medstead No. 497
Meeting Lake No. 466, Saskatchewan	redirect::Rural Municipality of Meeting Lake No. 466
Meota No. 468, Saskatchewan	redirect::Rural Municipality of Meota No. 468
Nimattullah Kassab	redirect::Nimatullah Kassab
Mervin No. 499, Saskatchewan	redirect::Rural Municipality of Mervin No. 499
Milden No. 286, Saskatchewan	redirect::Rural Municipality of Milden No. 286
Milton No. 292, Saskatchewan	redirect::Rural Municipality of Milton No. 292
Miry Creek No. 229, Saskatchewan	redirect::Rural Municipality of Miry Creek No. 229
Monet No. 257, Saskatchewan	redirect::Rural Municipality of Monet No. 257
Montmartre No. 126, Saskatchewan	redirect::Rural Municipality of Montmartre No. 126
Category:1948 establishments in North Korea	Other/None
Yeon (Korean given name)	Other
Brunella (disambiguation)	redirect::Brunella
Holcoponera (disambiguation)	redirect::Holcoponera
Montrose No. 315, Saskatchewan	redirect::Rural Municipality of Montrose No. 315
Moose Creek No. 33, Saskatchewan	redirect::Rural Municipality of Moose Creek No. 33
Moose Jaw No. 161, Saskatchewan	redirect::Rural Municipality of Moose Jaw No. 161
Moose Mountain No. 63, Saskatchewan	redirect::Rural Municipality of Moose Mountain No. 63
Moose Range No. 486, Saskatchewan	redirect::Rural Municipality of Moose Range No. 486
Gamelan Gambuh	redirect::Gambuh
Moosomin No. 121, Saskatchewan	redirect::Rural Municipality of Moosomin No. 121
Morris No. 312, Saskatchewan	redirect::Rural Municipality of Morris No. 312
Morse No. 165, Saskatchewan	redirect::Rural Municipality of Morse No. 165
Mount Hope No. 279, Saskatchewan	redirect::Rural Municipality of Mount Hope No. 279
Mount Pleasant No. 2, Saskatchewan	redirect::Rural Municipality of Mount Pleasant No. 2
Mountain View No. 318, Saskatchewan	redirect::Rural Municipality of Mountain View No. 318
Oberleutnant (Ing.)	redirect::Oberleutnant zur See
Newcombe No. 260, Saskatchewan	redirect::Rural Municipality of Newcombe No. 260
Nipawin No. 487, Saskatchewan	redirect::Rural Municipality of Nipawin No. 487
Serbian months	redirect::Slavic calendar
Developer kit	redirect::Software development kit
North Battleford No. 437, Saskatchewan	redirect::Rural Municipality of North Battleford No. 437
North Qu'Appelle No. 187, Saskatchewan	redirect::Rural Municipality of North Qu'Appelle No. 187
Norton No. 69, Saskatchewan	redirect::Rural Municipality of Norton No. 69
Oakdale No. 320, Saskatchewan	redirect::Rural Municipality of Oakdale No. 320
Draft:Ukraine Border Base Battle	redirect::Siege of the Luhansk Border Base
Old Post No. 43, Saskatchewan	redirect::Rural Municipality of Old Post No. 43
Wikipedia:Wikiproject Philippines	redirect::Wikipedia:Tambayan Philippines
Orkney No. 244, Saskatchewan	redirect::Rural Municipality of Orkney No. 244
Paddockwood No. 520, Saskatchewan	redirect::Rural Municipality of Paddockwood No. 520
Ethnicity in Metro Detroit	redirect::Ethnic groups in Metro Detroit
Parkdale No. 498, Saskatchewan	redirect::Rural Municipality of Parkdale No. 498
Gamelan gandrung	redirect::Gandrung
Paynton No. 470, Saskatchewan	redirect::Rural Municipality of Paynton No. 470
