Title	Category
Category:Koskikeskus	Other/None
Template:User Skype not positive	Other/None
Category:Buildings and structures under construction in Metro Manila	Other/None
María Teresa Ochoa Mejía	Person
Crișan (surname)	Other/None
Robert Poeti	redirect::Robert Poëti
Polski Cukier	Company
Macbeth (cancelled Olivier film)	redirect::Macbeth (unfinished film)
Religious homophobia	redirect::Homophobia#Religious attitudes
Leuconotopicus	Other/None
Oleksiy Bily	redirect::Oleksii Bilyi
Category:PEN/Malamud Award winners	C_Person
Home Economics–F.F.A. Building	Location
The Conspiracy (1914 film)	Other
Olha Belkova	redirect::Olga Bielkova
Gustavo Ortega Joaquín	Person
Category:Football clubs in Wrexham	Other/None
Andrew O'Donnell	Person
Player Select	Other
Reventazón Dam	Location
The Conspiracy (film)	redirect::Conspiracy (disambiguation)#Film and television
Alunna	redirect::Alavana
Wikipedia:TFAA	redirect::Template:TFA archive
Arbetslinjen	Other/None
Template:Jordan-film-stub	Other/None
List of lakes of Taiwan	Other/None
Laurence Ryder	Person
Loz Ryder	redirect::Laurence Ryder
Federico Ovalle	Person
Category:Sports in Davao del Norte	Other/None
Deceiver of the gods	redirect::Deceiver of the Gods
Newtown, Cumbria	Location
Deceiver Of The Gods	redirect::Deceiver of the Gods
Potamogeton × angustifolius	Other/None
Langenau Castle	Other/None
DOTG	redirect::Deceiver of the Gods
Wagner (crater)	A_Location
Colt Model 1839 Shotgun	redirect::Colt Model 1839 Carbine#Model 1839 Shotgun
Weightlifting at the 1978 Asian Games	C_Organization
European Journal of Clinical Microbiology & Infectious Diseases	Other
2010–11 Israeli Women's Cup	Other/None
Category:Works by Theodore Roosevelt	Other/None
Old US 67, Alicia to Hoxie	redirect::U.S. Route 67 in Arkansas
FIBA EuroBasket 2001 qualification	Other/None
Johnny Showalter	A_Person
2015 ANA Inspiration	C_Organization
FIBA EuroBasket 2001 squads	Other/None
Fahhad Al-Subaie	C_Person
Fahad Al-Subaie	redirect::Fahhad Al-Subaie
Al moraheqat	redirect::Teenagers (film)
Stan Rose (Canadian football)	A_Person
Blackman's theorem	Other/None
And While We Were Here (film)	redirect::And While We Were Here
Cristești (disambiguation)	redirect::Cristești
Étoile Sportive de Radès	Other/None
Danielle O'Hara	redirect::Danielle Lloyd
Nils Liljequist	Person
Template:2011–12 PFA Scotland Third Division Team of the Year	Other/None
Chytonix palliatricula	Other/None
Apamea iaspis	redirect::Chytonix palliatricula
Bryophila palliatricula	redirect::Chytonix palliatricula
Category:African-American girl groups	C_Person
Sins of the Father (Robin Hood)	redirect::List of Robin Hood (2006 TV series) episodes#ep30
Steele Creek Roadhouse	Location
File:NaplesAirport.svg	Other/None
Category:Works by Woodrow Wilson	Other/None
Wikipedia:WikiProject Spam/LinkReports/ajaydevgn.com	Other/None
Bluesmart	Company
Let the Games Commence	redirect::List of Robin Hood (2006 TV series) episodes#ep31
Head-tilt chin-lift	redirect::Head tilt/Chin lift
Cleora sublunaria	Other/None
John B. Wells	Person
Category:Companies based in Kristiansand	C_Organization
Starling Bank	Company
Norm Green (runner)	C_Person
Head-tilt/chin-lift	redirect::Head tilt/Chin lift
A Dangerous Deal	redirect::List of Robin Hood (2006 TV series) episodes#ep35
Cercle des Philadelphes	Other/None
Janusz Adam Kobierski	C_Person
Saala Khadoos	redirect::Irudhi Suttru
Operation Pigfat	Other
Uppå källarbacken	Other/None
Boarmia transfixaria	redirect::Cleora sublunaria
Boarmia atrolinearia	redirect::Cleora sublunaria
Cleora areataria	redirect::Cleora sublunaria
Boarmia sublunaria	redirect::Cleora sublunaria
Military Training Leader	redirect::Military training leader
J.W. Jones	redirect::J. W. Jones
Elvis Kotorri	Person
Coleotechnites variella	redirect::Coleotechnites variiella
Do You Love Me? (Robin Hood)	redirect::List of Robin Hood (2006 TV series) episodes#ep32
Too Hot to Handle (Robin Hood)	redirect::List of Robin Hood (2006 TV series) episodes#ep33
The King Is Dead, Long Live the King… (Robin Hood)	redirect::List of Robin Hood (2006 TV series) episodes#ep34
Coleotechnites variiella	Other/None
Gelechia variiella	redirect::Coleotechnites variiella
Maya, Baztan	redirect::Amaiur-Maya
Jaw-thrust maneuver	Other
Tanet	Other
Hapoel Acre F.C. (women)	Other/None
Category:Bakırköyspor managers	Other/None
