Title	Category
Careg Dwfn	redirect::Carreg Dwfn
Careg dwfn	redirect::Carreg Dwfn
Light goods vehicle	redirect::Light commercial vehicle
Careg-y-dwfan	redirect::Carreg Dwfn
Wernya fufifasciata	redirect::Wernya rufifasciata
Lalah Beg	redirect::Jahangir Quli Beg
Ruxandra Dumitrescu	Person
Sospan Dau	Other
Draft:Moda Domani Institute	redirect::Moda Domani Institute
Category:Silurian Illinois	Other/None
Template:Did you know nominations/Hannah Newell Noyes	Other/None
Category:Paleogene Illinois	Other/None
Wikipedia:WikiProject Medicine/Translation task force/RTT/Simple acute bronchitis	Other
George M. Marakas	Person
Mimozethes nana	redirect::Mimozethes argentilinearia
Euchera nana	redirect::Mimozethes argentilinearia
Decetia argentilinearia	redirect::Mimozethes argentilinearia
Category:Devonian Illinois	Other/None
Midwest Zodiac Talon-Turbine	Other
Zürichbergtunnel	redirect::Zürichberg Tunnel
22nd General Assembly of Newfoundland	Other
Category:Ordovician Illinois	Other/None
Category:Full Force albums	Other/None
Sunstrand	redirect::Sundstrand Corporation
Pug Davis	redirect::Peter George Davis
Category:Tooting & Mitcham United F.C. managers	Other/None
Simon Jong	redirect::Simon De Jong
William Robertson Gray	redirect::Bill Gray (American football)
Marc Gotlieb	C_Person
William Gray, Jr.	redirect::Bill Gray (American football)
Elly Griffiths	C_Person
Heteromiza lycoraearia	redirect::Mimozethes lilacinaria
Category:Films based on works by John Osborne	Other/None
Decetia lilacinaria	redirect::Mimozethes lilacinaria
Wikipedia:Peer review/Casey Abrams (album)/archive1	Other/None
Virginia M. Tutt	redirect::Virginia Tutt
Harvey's Resort Hotel	redirect::Harveys Lake Tahoe
Chrome Mozilla	redirect::XUL
Orange Blossom Carnival	C_Organization
Rituraj Singh (actor)	Person
Sir Horace Plunket	redirect::Horace Plunkett
Category:Canadian school superintendents	Other/None
Pattern wheel	redirect::Tracing wheel
Pounce wheel	redirect::Tracing wheel
Dart wheel	redirect::Tracing wheel
Paul James Lockyer	redirect::Paul Lockyer
Journal of American Chemical Society	redirect::Journal of the American Chemical Society
Category:Sabuesos de Holquin players	Other/None
Talaash (Colors TV series)	redirect::Code Red (Indian TV series)
Bishop Clancy of Elphin	redirect::John Joseph Clancy (bishop)
Herbert Pfuhl Jr.	redirect::Herb Pfuhl
Herbert Pfuhl	redirect::Herb Pfuhl
Draft:Pete Steinkopf	redirect::The Bouncing Souls
Flat Jack (radar)	redirect::Tupolev Tu-126
Horithyatira delattini	redirect::Thyatira delattini
Robert Scott Robertson, III	redirect::Scotty Robertson
Robert Scott Robertson III	redirect::Scotty Robertson
Robert Scott Robertson	redirect::Scotty Robertson
Neololeba atra	Other/None
Robert Robertson, III	redirect::Scotty Robertson
Syriyka	redirect::Kepka-afganka
Robert Robertson III	redirect::Scotty Robertson
Carl Andreas Göpfert	C_Person
Template:Ninja Theory	Other/None
Category:Nigerian people by period	Other/None
Bambusa atra	redirect::Neololeba atra
Joseph Starr Dunham House	Location
United States District Court, Southern District of New York	redirect::United States District Court for the Southern District of New York
German destroyer TA 20	redirect::Italian destroyer Audace (1916)
AIna Muceniece	redirect::ECHO-7
Draft:Pneumovirus	redirect::Orthopneumovirus
Zodiac Talon-Turbine	redirect::Midwest Zodiac Talon-Turbine
Zodiac Talon	redirect::Midwest Zodiac Talon-Turbine
Midwest Zodiac Talon	redirect::Midwest Zodiac Talon-Turbine
Scion iA	redirect::Mazda Demio#Scion iA
Midwest Zodiac	redirect::Midwest Zodiac Talon-Turbine
Information Technology Act 2000	redirect::Information Technology Act, 2000
Midwest Talon	redirect::Midwest Zodiac Talon-Turbine
Kourotrophos	Other/None
Controlled Combustion Engine	redirect::Controlled combustion engine
Balamban, Cebu	redirect::Balamban
Chemical carcinogen	redirect::Carcinogen
Pneumovirus	redirect::Orthopneumovirus
Rituraj Singh (Indian TV actor)	redirect::Rituraj Singh (actor)
Scott Robertson, III	redirect::Scotty Robertson
Scott Robertson III	redirect::Scotty Robertson
Jimi Hendrix videography	Other/None
Gaurena florina	redirect::Thyatira florina
Li Jian (singer)	C_Person
I'll Be Fine (Janita song)	redirect::Janita
1942 Birthday Honours	Other/None
Nhân Văn–Giai Phẩm movement	redirect::Nhân Văn–Giai Phẩm affair
Malkot, Nepal	C_Location
Template:Helen Hooven Santmyer	C_Person
George Basil Popov	C_Person
Map of Salvation	Other
Jerome Joseph Shestack	redirect::Jerome J. Shestack
Jerry Shestack	redirect::Jerome J. Shestack
Bambusa polymorpha	Other/None
Gladestony	Person
