Title	Category
KPMF-LD	C_Location
1981 U.S. Clay Court Championships - Men's Doubles	redirect::1981 U.S. Clay Court Championships – Men's Doubles
2016–17 Leyton Orient F.C. season	C_Person
1929-30 Brentford F.C. season	redirect::1929–30 Brentford F.C. season
2016-17 Hong Kong Premier League	redirect::2016–17 Hong Kong Premier League
Lanke Cup	redirect::Quzhou-Lanke Cup
1982 U.S. Clay Court Championships - Women's Doubles	redirect::1982 U.S. Clay Court Championships – Women's Doubles
1981 U.S. Clay Court Championships - Men's Singles	redirect::1981 U.S. Clay Court Championships – Men's Singles
Rif Dimashq offensive (February–April 2018)	C_Organization
Quzhou Lanke Cup	redirect::Quzhou-Lanke Cup
Bourkou Louise Kabo	C_Person
KVTU-LD	C_Location
Ashwattha	C_Person
Moto G4	Other
Valea Vișeului, Maramureș	redirect::Bistra, Maramureș
Category:Films scored by Arun Paudwal	Other/None
Kentucky Route 1681	Other
Category:Tubize	C_Location
Category:Films scored by Babul Bose	Other/None
Moto G Plus	redirect::Moto G4
Moto G Play	redirect::Moto G4
Governance of Brazil	redirect::Federal government of Brazil
Johann Sulzer (disambiguation)	redirect::Johann Sulzer
Giorgio nottoli	redirect::Giorgio Nottoli
Category:Panchayats in Koduvally Block	Other/None
Motorola Moto G (4th generation)	redirect::Moto G4
Moto G 4th generation	redirect::Moto G4
AirDine	Company
Public survey	redirect::Survey (human research)
Cassa di Risparmio di Carrara	Company
Moto G 2016	redirect::Moto G4
Moto G (2016 version)	redirect::Moto G4
Moto G (2016 Version)	redirect::Moto G4
C.R. Carrara	redirect::Cassa di Risparmio di Carrara
CR Carrara	redirect::Cassa di Risparmio di Carrara
2016 Gustav Mahler Conducting Competition	Other/None
Uladzimir Malyshaw	Person
Category:Gustav Mahler Conducting Competition	Other/None
Foreverland	Other
Kappa Alpha Pi National Fraternity	redirect::Kappa Alpha Pi (secondary)
Fondazione Cassa di Risparmio di Carrara	redirect::Cassa di Risparmio di Carrara
Category:People from Tubize	Other/None
Fondazione CR Carrara	redirect::Cassa di Risparmio di Carrara
Moto G4 Plus	redirect::Moto G4
Moto G4 Play	redirect::Moto G4
Ali Hazami	Person
Bowdoin Project	Other
Category:Mass media in Bowling Green, Kentucky	Other/None
Media in Bowling Green, Kentucky	Other/None
Second Sturgeon government	Other
Category:2016 establishments in Scotland	Other/None
Phi Chi Medical Fraternity	redirect::Phi Chi
Category:African-American people in Indiana politics	Other/None
Reduced major axis regression	redirect::Total_least_squares#Scale_invariant_methods
Major axis regression	redirect::Total_least_squares#Scale_invariant_methods
Standardised major axis regression	redirect::Total_least_squares#Scale_invariant_methods
Least products regression	redirect::Total_least_squares#Scale_invariant_methods
Least areas regression	redirect::Total_least_squares#Scale_invariant_methods
Category:African-American state legislators in Indiana	Other/None
Nikolai Prudnikov	Person
Alexandru Lăpușan	A_Person
My Family's Beautiful!	Other
Nikolay Prudnikov	redirect::Nikolai Prudnikov
¡Qué linda es mi familia!	redirect::My Family's Beautiful!
Radiation skyshine	redirect::Skyshine
Ali Gholami	Person
Titanosaurus madagscariensis	redirect::Titanosaurus
Airshine	redirect::Skyshine
Category:Films scored by Vanraj Bhatia	Other/None
Medovets	Location
The Killing (1956 film)	redirect::The Killing (film)
Category:Counts of Stade	Other/None
Hamed Bahiraei	Person
Cha mongkut	Other/None
Skyshine effect	redirect::Skyshine
Wikipedia:Collect's Laws	redirect::Wikipedia:Repetition in Argumentation
Lovey (singer)	Person
I Want to Be a Chorus Girl	Other
Yo quiero ser bataclana	redirect::I Want to Be a Chorus Girl
Ola Lånke	redirect::Ola T. Lånke
Almas Japua	C_Person
Israel Mazin	Person
Bach Media	Other/None
Ola Lanke	redirect::Ola T. Lånke
Vuélveme a querer	redirect::Vuélveme a Querer
Vuélveme a Querer (song)	redirect::Vuélveme a Querer
Ola Torgeir Lånke	redirect::Ola T. Lånke
Caricarrara	redirect::Cassa di Risparmio di Carrara
Suva Sevens	redirect::Fiji Sevens
Ola Torgeir Lanke	redirect::Ola T. Lånke
Moscow German School	redirect::German School Moscow
Bach media	redirect::Bach Media
VSDC Free Video Editor	Other
Driving Miss Moesha	redirect::List of Moesha episodes
Category:Fiji Sevens	Other/None
Genron NPO	C_Organization
Meranti wood	redirect::Shorea
Prioniodinina	redirect::Ozarkodinida
History of Santa Cruz, California	redirect::Santa Cruz, California#History
Ozarkodinina	redirect::Ozarkodinida
