Title	Category
Sachidanand Pandey	Person
Nara Sangyo University	redirect::Nara Gakuen University
Kim Yoo-jin (men's footballer)	redirect::Kim Yoo-jin (footballer, born 1983)
Matej Hliničan	Person
Category:Nara Gakuen University alumni	C_Person
Anthony McCracken	Person
Chama elegans	redirect::Centrocardita aculeata
Ronan Raftery	Person
Othello, New Jersey	C_Location
Cardita elegans (Lamarck, 1806)	redirect::Cyclocardia elegans
Champ Hood	Person
Cardita elegans (Requien, 1848)	redirect::Cyclocardia elegans
Assam Gramin Vikash Bank	Company
Mon Uncle	redirect::Mon Oncle
Typhoon Vongfong (disambiguation)	redirect::Tropical Storm Vongfong
Quand passent les cigognes	redirect::The Cranes Are Flying
Chrestinah Kgatlana	redirect::Thembi Kgatlana
Laurent Éon de Cély	Other/None
Byelorussian partisans	redirect::Belarusian resistance during World War II
Tropical Storm Maysak	redirect::Typhoon Maysak
Brexit Referendum	redirect::2016 United Kingdom European Union membership referendum
Typhoon Maysak (disambiguation)	redirect::Typhoon Maysak
Merpati Nusantara Airlines Flight 6517	C_Organization
Paulo Roberto Cotechiño centravanti di sfondamento	Other
Lady Football	redirect::Paulo Roberto Cotechiño centravanti di sfondamento
Tropical Storm Nangka	redirect::Typhoon Nangka
Belarusian collaboration with the Axis powers	redirect::Byelorussian collaboration with Nazi Germany
2016 Iranian Super Cup	Other
Typhoon Nangka (disambiguation)	redirect::Typhoon Nangka
Category:Hamanaka, Hokkaido	C_Location
Category:Danish Medical Association	Other/None
Tilkanagar	Other/None
Centrodinium	Other/None
Tropical Storm Goni	redirect::Typhoon Goni
Category:Kushiro, Hokkaido (town)	C_Location
Typhoon Goni (disambiguation)	redirect::Typhoon Goni
Brunei-United States Treaty of Peace, Friendship, Commerce and Navigation	redirect::Brunei–United States Treaty of Peace, Friendship, Commerce and Navigation
Draft:Hombres (poetry)	redirect::Hombres (poetry collection)
Draft:System for Observing Play and Recreation in Communities (SOPARC)	redirect::System for Observing Play and Recreation in Communities
Template:Australia squad – 2011 Rugby League Four Nations	Other/None
Draft:JanPak	redirect::JanPak
Ribonucleic acid polymerase	redirect::RNA polymerase
Luis Bezeta	Person
Rumania Montevideo	Person
Pavillard	redirect::Henri Pavillard
Oxytoxum elegans	Other/None
Centrodinium elegans	redirect::Oxytoxum elegans
Template:Did you know nominations/Racket-tailed roller	Other/None
Record of Grancrest War	Other
Grancrest Senki	redirect::Record of Grancrest War
Gallileo	redirect::Galileo Galilei
2016 UEC European Track Championships – Women's points race	Other
La Valette-lès-Toulon	redirect::La Valette-du-Var
2016–17 Barangay Ginebra San Miguel season	Other
Necropolis of Pranu Muttedu	Location
Gamers!	Other
Category:Association football people from Kōchi Prefecture	C_Person
1938 Curtis Cup	Other
2016–17 Rain or Shine Elasto Painters season	Other
November internationals	redirect::Autumn rugby union internationals
Template:Perth Glory FC W-League squad	redirect::Template:Perth Glory FC (W-League) squad
Draft:Bidyut Baran Chaudhuri	redirect::Bidyut Baran Chaudhuri
Rylsky Institute of Art Studies, Folklore and Ethnology	Other/None
Template:Did you know nominations/Helmut Schlegel	Other/None
Miriam Silva da Paixão	redirect::Mirian Silva de Paixão
Siota	C_Location
Ashley Mehrotra	Person
Desert modern	redirect::Mid-century modern#Mid-century modern in Palm Springs
Amman K. Arjunan	C_Person
Claire Bertrand (painter)	C_Person
Odone Belluzzi	C_Person
Alexander Krushelnitskiy	Person
Tony Gillies	Person
Anthony Gillies	redirect::Tony Gillies
Euphorically	redirect::Euphoria
Template:Sabah Heritage Party/meta/color	Other/None
New World (group)	redirect::2016 Dyn cyberattack#Perpetrators
Template:Sabah Heritage Party/meta/shading	Other/None
Castle of Gioiosa Guardia	Other/None
Sinforosa Eyang	redirect::Sinforosa Eyang Nguema Nchama
Willy Eisenschitz	C_Person
51 Aerospace Control and Warning Squadron	redirect::51 Aerospace Control and Warning Operational Training Squadron
Category:Castles in Sardinia	Other/None
Chorio, Othoni island	redirect::Chorio, Othonoi
Anastasia Bryzgalova	Person
Category:People from Gwangyang	Other/None
Pooran Chand Joshi	C_Person
Dirtyc0w	redirect::Dirty COW
Charles Pietri	Person
Joong-ki	redirect::Song Joong-ki
Independent Print	redirect::The Independent
Henriod	Other/None
Emile Yves Picot	C_Person
Category:People from Gimje	Other/None
Castle of Acquafredda	Other/None
Category:Nelson City Councillors	Other/None
Villa Pandolfini	Other/None
David A. McNeill	C_Person
Lake Ballivián	Other/None
Joannes Disma Floriantschitsch de Grienfeld	Other/None
