Title	Category
Lahoriye	Other
Category:Petaling Jaya Rangers F.C. managers	Other/None
Category:Petaling Jaya Rangers F.C.	Other/None
Hiawatha, the Messiah of the Ojibway	Other/None
Blotched palm-pit viper	redirect::Bothriechis supraciliaris
Category:Sport in Selangor	Other/None
Good Luck America	Other
Jürgen Walter (Singer)	redirect::Jürgen Walter (singer)
Category:Petaling Jaya Rangers F.C. players	Other/None
Blaze (2018 film)	C_Person
Hollow-base bullet	Other/None
Alexei Klishin	Person
Edward Sears	redirect::Teddy Sears
K.C.H.	redirect::KCH
Road to Rio Program	Other/None
Jiang Lifu	Person
Category:Mizoram People's Conference politicians	C_Person
Archie's Family Restaurants	Other/None
Category:Mizoram politicians by party	C_Person
George Spencer (priest)	redirect::Ignatius Spencer
There Is a Cloud	C_Person
Sir Alexander Forrester Inglis Cochrane	redirect::Alexander Cochrane
Zimbabwean cricket team in Scotland in 2017	Other
There is a Cloud	redirect::There Is a Cloud
Category:Sindechites	Other/None
From Deewee	Other
Zimbabwe cricket team in Scotland in 2017	redirect::Zimbabwean cricket team in Scotland in 2017
The Good Son (TV series)	Other
Lubotyn (disambiguation)	redirect::Lubotyń
St John the Baptist Parish Church, Aberdare	redirect::St John's Church, Aberdare
Suribachi and surikogi	redirect::Suribachi
Category:Errors reported by Module:FindFeatures/bounds	Other/None
Category:Distacodontidae	Other/None
1919–20 Welsh Amateur Cup	Other
Category:Historic building pages with no ISO subdivision field	Other/None
Category:Zionism in Pakistan	Other/None
Romanian voting system referendum, 2007	redirect::2007 Romanian electoral system referendum
Mary T. Wojtyla	redirect::Pedestrian railroad safety in the United States#Notable deaths
Patrick Pouyane	redirect::Patrick Pouyanné 
Defending Your Life (Supernatural)	redirect::Supernatural (season 7)#ep130
Kacio Freitas	redirect::Kacio Fonseca
Kuwait–Qatar relations	Other
Luz Daniela Gaxiola	redirect::Daniela Gaxiola
Category:21st-century Spanish sculptors	Other/None
Dalila Rodríguez	redirect::Dalila Rodríguez Hernandez
¿Con qué sueñas?	Other
Nándor Zsolt	C_Person
Category:Indian selected picture candidates	Other/None
Ospedale Maggiore	redirect::Policlinico of Milan
The SAP scale	redirect::COPINE scale
Template:USCongRep/KY/35	Other/None
Category:Artists requiring a direct DNB link	Other/None
Mišov	redirect::Míšov
Beth Zachariah	redirect::Azekah
Steve Woznick	redirect::Steven Woznick
James Scott Howard	Person
514A	redirect::List of Gotham characters#Subject 514A
Subject 514A	redirect::List of Gotham characters#Subject 514A
Jack Simes	redirect::Jackie Simes
Peter Barbey	Person
Category:1930s in Copenhagen	Other/None
Category:2000s in Turin	Other/None
Category:1930s in Milan	Other/None
Category:Decades in Turin	Other/None
Jame Carney	redirect::James Carney (cyclist)
Peter D. Barbey	redirect::Peter Barbey
Category:Decades in Milan	Other/None
Leptospermum subtenue	Other/None
Category:1980s in Turin	Other/None
Category:1990s in Milan	Other/None
Sir Robert Cavendish Spencer	redirect::Robert Cavendish Spencer
Category:1920s in Milan	Other/None
Category:1990s in Turin	Other/None
Francesco Orlando (footballer)	Person
Category:1970s in Turin	Other/None
Category:1950s in Turin	Other/None
Leptospermum rotundifolium	Other/None
Battle of Shen-Liao	Other
Eline McGeorge	C_Person
Category:2000s in Milan	Other/None
Åland art colony	redirect::Önningeby artists' colony
Marcelo Arrue	redirect::Christian Arrue
Category:2010s in Milan	Other/None
Category:1970s in Milan	Other/None
Category:1960s in Milan	Other/None
Category:1980s in Milan	Other/None
List of Georgetown Hoyas in the NBA and WNBA Drafts	redirect::List of Georgetown Hoyas in the NBA and WNBA drafts
List of Oklahoma Sooners in the NBA and WNBA Drafts	redirect::List of Oklahoma Sooners in the NBA and WNBA drafts
International Fruit and Vegetable Juice Association	Other/None
Round leaved tea tree	redirect::Leptospermum rotundifolium
Nicholas Siega	Person
Round leaved teatree	redirect::Leptospermum rotundifolium
Round leafed tea tree	redirect::Leptospermum rotundifolium
Round leafed teatree	redirect::Leptospermum rotundifolium
South Wales Guardian	Other
Round leaf tea tree	redirect::Leptospermum rotundifolium
Round leaf teatree	redirect::Leptospermum rotundifolium
Round leaved ti tree	redirect::Leptospermum rotundifolium
Category:1920s in Turin	Other/None
Anna De Costa Banks	redirect::Anna DeCosta Banks
