Title	Category
House Tornado (album)	redirect::House Tornado
State of Change	Other
1954 FIFA World Cup squads	Other/None
Brandão (footballer, born 1980)	Person
James E. Hayes	Person
Cryptocrystal	redirect::Cryptocrystalline
Duisbourg	redirect::Duisburg
List of the 100 Largest Cities in the United States	redirect::List of United States cities by population
File:Monument Valley 2.jpg	Other/None
Category:Restaurants in Ohio	C_Location
John J. Phelan	Person
FINA water polo	redirect::FINA Water Polo World League
Mikael Lindström	C_Person
FINA World Water Polo League	redirect::FINA Water Polo World League
James T. Mullen	Person
Gynerium sagitatum	redirect::Gynerium
FINA Water Polo League	redirect::FINA Water Polo World League
Sangre de cristo	redirect::Sangre de Cristo
The Romance of Crime	Other
'Big Ger' Cafferty	"redirect::List of Inspector Rebus characters#Morris Gerald ""Big Ger"" Cafferty"
George Wallace (Australian comedian)	Person
List of Billboard 200 number-one albums of 1983	Other/None
Template:Infobox actor voice	redirect::Template:Infobox person
Star Fox Armada	redirect::Star Fox: Assault
Love and War and Snow	redirect::List of Gilmore Girls episodes#Season 1 (2000–01)
South African Football Players Union	Organization
Murray Vaughan	C_Person
Jeff Lorber	Person
Upshot-Knothole Grable	C_Organization
Legislative Assembly of New South Wales	redirect::New South Wales Legislative Assembly
Cystoid macular oedema	redirect::Macular edema
Zhou Li	redirect::Rites of Zhou
Saint-Raphaël, Quebec	Location
Millennial Rites	Other
Saint-Nazaire-de-Dorchester, Quebec	Location
List of hispanophones	Other/None
Musicians Union of South Africa	Organization
Notre-Dame-Auxiliatrice-de-Buckland, Quebec	Location
Lepenac	Location
Anaheim Hills of California	redirect::Anaheim Hills
Gram equivalent	redirect::Equivalent weight
Wikipedia:GALLERY	redirect::Wikipedia:Image use policy#Image galleries
Lords of the Storm	Other
Mark Shepherd (Vermont politician)	redirect::Mark Shepard
Category:Congress of South African Trade Unions	C_Organization
Jamalpur Locomotive Workshop	Other/None
Allen C. Skorepa	Person
Debrune	redirect::Romulan#Origins
Belarusian Autocephalous Orthodox Church	Other/None
Under Secretary of Energy for Science	Other/None
Detective Sergeant John Rebus	redirect::John Rebus
Azumi-zoku	redirect::Azumi people
List of German exonyms for places in the Czech Republic	Other/None
Armenian Sisters Academy	Other/None
Sony-Ericsson	redirect::Sony Mobile
Siddiq	Other/None
Azumi (peoples)	redirect::Azumi people
The Company (folk rock band)	Other/None
Courtesy call	Other/None
File:Alan jackson.jpg	Other/None
Battle of Wartenburg	redirect::Wartenburg (Kemberg)
Fibras Industriales S.A.	Other/None
Radiographer	Other
Wang Xiang	Person
Chaperon (headgear)	Other/None
Chaperon (cap)	redirect::Chaperon (headgear)
Marshal Macdonald	redirect::Jacques MacDonald
Let Yourself Go (808 State song)	Other
Dramatists Play Service	Other
CXOU J061705.3+222127	Other/None
J061705.3+222127	redirect::CXOU J061705.3+222127
J0617	redirect::CXOU J061705.3+222127
File:James Willmott-Brown.jpg	Other/None
Paul Jabara	Person
Guanqiu Xiu	redirect::Guanqiu Jian
Derived works of The Raven	"redirect::Allusions to Poe's ""The Raven"""
Lady Luck (rapper)	Person
Cerca trova	redirect::The Battle of Anghiari (Leonardo)
Barradas III	redirect::Star Trek Customizable Card Game
Envirocare Utah Classic	redirect::Utah Championship
Diplomatic corp	redirect::Diplomatic corps
Seal of Bucharest	redirect::Coat of arms of Bucharest
Cold Fusion (novel)	Other
German exonyms (Karlovy Vary Region)	Other/None
Guanqiu Dian	redirect::Guanqiu Jian
Cimarron River (Colorado)	redirect::Cimarron River
Girl friend	redirect::Girlfriend
Barradas system	redirect::Gambit (Star Trek: The Next Generation)
Rod McCall	Person
United States Ambassadors to the United Nations	redirect::List of ambassadors of the United States to the United Nations
Raymond Jablonski	redirect::Ray Jablonski
IC443	redirect::IC 443
Confederation of South African Workers' Unions	Organization
IC-443	redirect::IC 443
CONSAWU	redirect::Confederation of South African Workers' Unions
WWF Superstars 2	Other
Treaty of Kalisch	redirect::Treaty of Kalisz
Confederation of South African Workers Unions	redirect::Confederation of South African Workers' Unions
CXOU J0617	redirect::CXOU J061705.3+222127
The Battle of Anghiari (Leonardo)	Other/None
