Title	Category
Yakubu Gowon	Person
Renegades (Rage Against the Machine album)	Other
Pontifical Institute of Mediaeval Studies	Other
Yakubu Gowan	redirect::Yakubu Gowon
Rogue planet	Other/None
Additive white gaussian noise	redirect::Additive white Gaussian noise
Sports writer	redirect::Sports journalism
Roger Lloyd-Pack	Person
Larvas	redirect::Larva
X-43A Hyper-X	redirect::NASA X-43
Alaska boundary dispute	Other/None
Henry Somerset, 1st Marquess of Worcester	Person
Traveling Salesman Problem	redirect::Travelling salesman problem
Evil Heat	Other
Dhahran, Saudi Arabia	redirect::Dhahran
Nida, Lithuania	Location
Dirty Hits	Other
Jugurthine War	Other
Gerhard Flesch	Person
Phoenix missile	redirect::AIM-54 Phoenix
Devil's Sea	Other/None
Cussing	redirect::Profanity
Africa Nova	redirect::Numidia (Roman province)#History
Information bottleneck method	Other/None
Compass variation	redirect::magnetic declination
21 Lutetia	Other
Craniosacral Therapy	redirect::Craniosacral therapy
Beni Ḥassān	Other/None
Joe Kinnear	C_Person
Black Sox	redirect::Black Sox Scandal
James Hoban	Other/None
Hassaniya Arabic	Other
Oregon Ballot Measure 51 (1997)	redirect::1994 Oregon Ballot Measure 16
William Young (Nova Scotia politician)	A_Person
Barney Hill	redirect::Barney and Betty Hill
Betty and Barney Hill	redirect::Barney and Betty Hill
Scatman John	Person
Medieval studies	Other/None
Mahabali	Other
Mickey Redmond	Person
Baton Broadcast System	Other
List of alternative rock artists	C_Person
Living Marxism	Other/None
John Paul Larkin	redirect::Scatman John
Benjamin Paul Blood	Other/None
Ed Graham	Person
David J. Stevenson	Person
Foundation For A Free Information Infrastructure	redirect::Foundation for a Free Information Infrastructure
Ikeja	Location
Wikipedia:WikiProject Webcomics/Notability and inclusion guidelines	redirect::Wikipedia:Notability (web)
Mawenzi	redirect::Mount Kilimanjaro
Quantum loop theory	redirect::loop quantum gravity
Optimize (magazine)	Other/None
Mike McCready	Person
James William Johnston	Person
The Scatman	redirect::Scatman John
St. Michael's College (U of T)	redirect::University of St. Michael's College
Athletics at the 2000 Summer Olympics	C_Person
WIN-4	redirect::WIN Television
Rave Master	Other
Dihydroxyacetone	Other/None
Aust	C_Location
Mary di Michele	C_Person
Wylie transliteration	Other/None
Live at the Rainbow	Other
Language evolution	redirect::evolutionary linguistics
U-chen script	redirect::Uchen script
A403 road	Other/None
List of Pittsburgh neighborhoods	Other/None
Taylor & Francis	C_Company
Pokémon Adventures	Other
Kells, County Meath	Location
HMCS Oakville	Other
Ferdinand Adolf August Heinrich, Count von Zeppelin	redirect::Ferdinand von Zeppelin
Wicketkeeper	redirect::Wicket-keeper
Johann Kaspar Zeuss	Person
List of Movies/TV Shows Affected by September 11	redirect::List of entertainment affected by the September 11 attacks
Merry Christmas, Mr. Lawrence	Other
Baron Paget	redirect::Marquess of Anglesey
Andrei Alexandrovich Zhdanov	redirect::Andrei Zhdanov
Lord Paget	redirect::Marquess of Anglesey
Zhelyu Zhelev	A_Person
Vladimir Volfovich Zhirinovsky	redirect::Vladimir Zhirinovsky
Petar Zhivkovic	redirect::Petar Živković
Yóu Xíkun	redirect::Yu Shyi-kun
The Gaffer	redirect::Gaffer
Petar Živković	A_Person
Leigh syndrome	Other
List of frivolous parties	redirect::List of frivolous political parties
Vasily Andreyevich Zhukovski	redirect::Vasily Zhukovsky
Yu Shyikun	redirect::Yu Shyi-kun
CD4 T-cell	redirect::T helper cell
Yu Shyi-Kun	redirect::Yu Shyi-kun
Vasily Andreyevich Zhukovsky	redirect::Vasily Zhukovsky
Wikipedia:Goings-on/March 28, 2004	Other/None
Chén Shuibian	redirect::Chen Shui-bian
Mohammed Zia ul-Haq	redirect::Muhammad Zia-ul-Haq
Ch'en Shui-pien	redirect::Chen Shui-bian
Ch'en Shuipien	redirect::Chen Shui-bian
Ch'en Shui-Pien	redirect::Chen Shui-bian
