Title	Category
Tacitus (emperor)	redirect::Marcus Claudius Tacitus
Jarred Shaw	Person
Harrow International School Shanghai	A_Location
SMRT Headquarters Building	redirect::SMRT Corporation
Charleston Golden Eagles baseball	redirect::Charleston Golden Eagles
Swimming at the 2015 Parapan American Games - Men's 50 metre freestyle S3	redirect:::Swimming at the 2015 Parapan American Games – Men's 50 metre freestyle S3
1924-25 Southern Branch Grizzlies men's basketball team	redirect:::1924–25 Southern Branch Grizzlies men's basketball team
1923-24 Southern Branch Cubs men's basketball team	redirect:::1923–24 Southern Branch Grizzlies men's basketball team
1923-24 Southern Branch Grizzlies men's basketball team	redirect:::1923–24 Southern Branch Grizzlies men's basketball team
Swimming at the 2015 Parapan American Games - Men's 50 metre freestyle S8	redirect:::Swimming at the 2015 Parapan American Games – Men's 50 metre freestyle S8
Swimming at the 2015 Parapan American Games - Men's 50 metre freestyle S4	redirect:::Swimming at the 2015 Parapan American Games – Men's 50 metre freestyle S4
1926-27 Southern Branch Grizzlies men's basketball team	redirect:::1926–27 Southern Branch Grizzlies men's basketball team
1925-26 Southern Branch Grizzlies men's basketball team	redirect:::1925–26 Southern Branch Grizzlies men's basketball team
Lorenz Bäumer	C_Person
Yang Shoucheng	redirect::Albert Yeung
1927-28 UCLA Bruins men's basketball team	redirect:::1927–28 UCLA Bruins men's basketball team
Machete (cyclist)	redirect::Juan Carlos Arias Acosta
2018 ISAF Sailing World Cup	redirect::Sailing World Cup
Klau and Buena Vista Mine Superfund site	Other/None
7F00FF	redirect::Violet (color)
Texas Central	redirect::Texas Central Railway
4B0082	redirect::Indigo
FF7F00	redirect::Orange (colour)
FFC0CB	redirect::Pink
Fastelavnsbolle	redirect::Semla
3F00FF	redirect::Ultramarine
The Falcons have landed	redirect::Falcon Heavy test flight
List of biometrics policies	redirect::Countries applying biometrics
Biometrics by country	redirect::Countries applying biometrics
Canon professor	redirect::Canon (priest)#Canon professors
BFFF00	redirect::Lime (color)
Ithaca Bombers men's basketball	redirect::Ithaca College#Athletics
Wilkes Colonels men's basketball	redirect::Wilkes University#Athletics
Reabrook Valley	redirect::Rea Brook Valley
Ministry of Local Governments (Turkey)	Other/None
SpaceX Tesla Roadster	redirect::Elon Musk's Tesla Roadster
Space Tesla Roadster	redirect::Elon Musk's Tesla Roadster
Tesla Roadster in space	redirect::Elon Musk's Tesla Roadster
Space Tesla	redirect::Elon Musk's Tesla Roadster
Space Roadster	redirect::Elon Musk's Tesla Roadster
Tesla in space	redirect::Elon Musk's Tesla Roadster
SpaceX Falcon Heavy Tesla Roadster	redirect::Elon Musk's Tesla Roadster
Roadster in space	redirect::Elon Musk's Tesla Roadster
SpaceX Falcon Heavy Roadster	redirect::Elon Musk's Tesla Roadster
SpaceX Tesla	redirect::Elon Musk's Tesla Roadster
Falcon Heavy Tesla Roadster	redirect::Elon Musk's Tesla Roadster
SpaceX Roadster	redirect::Elon Musk's Tesla Roadster
Falcon Heavy Roadster	redirect::Elon Musk's Tesla Roadster
Category:Wilkes Colonels men's basketball coaches	C_Person
Category:Wilkes Colonels men's basketball	Other/None
Gennady Leonov	Person
Chromatic scales	redirect::Chromatic scale 
Not a Flamethrower	redirect::The Boring Company
Boring Flamethrower	redirect::The Boring Company
Not A Flamethrower	redirect::The Boring Company
Boring Company Flamethrower	redirect::The Boring Company
The Boring Company Flamethrower	redirect::The Boring Company
Elon Musk Flamethrower	redirect::The Boring Company
** (2018)	redirect::2018 Winter Paralympics
Video-feed	redirect::Video
Videofeed	redirect::Video
** (Paralympics)	redirect::2018 Winter Paralympics
** (PyeongChang)	redirect::2018 Winter Paralympics
Isku-dheh-karis, isku-dheh karis	redirect::Somali cuisine
Pashtun Tahafuz Movement	Organization
Pashtun Tahaffuz Movement	redirect::Pashtun Tahafuz Movement
Mehsud Tahaffuz Movement	redirect::Pashtun Tahafuz Movement
Mehsud Tahafuz Movement	redirect::Pashtun Tahafuz Movement
Mahsud Tahafuz Movement	redirect::Pashtun Tahafuz Movement
Mahsud Tahaffuz Movement	redirect::Pashtun Tahafuz Movement
Wikipedia:WikiProject Spam/Local/knowledgesuttra.com	Other/None
Deon Jones	Person
Kim Ji-Hoon (sailor)	redirect::Kim Ji-hoon (sailor)
Kim Chang-Ju	redirect::Kim Chang-ju
Italian Wikiquote	redirect::Wikiquote#Multi-lingual cooperation
Abhinav Tandel	Person
Science-fiction comics	redirect::Science fiction comics
Science-fiction convention	redirect::Science fiction convention
Kapò (1960 film)	redirect::Kapo (1960 film)
Santiago Raú Lange	redirect::Santiago Lange
Sanjeet Desai	Person
Science-fiction fandom	redirect::Science fiction fandom
Category:Cultural depictions of Golda Meir	C_Person
Wuling National Forest Recreation Area	Location
Category:Cultural depictions of Israeli people	Other/None
Category:Cultural depictions of ancient Israelite and Judean people	Other/None
Puneet Kumar	Person
Woolundunga, South Australia	Location
Denise Harper Angel	Person
Colten Boushie	redirect::Shooting of Colten Boushie
Kirstie Clements	Person
Helena Cooper-Thomas	Person
Steve Negron	Person
Elisabetta Cocciaretto	Person
Ryan John	Person
Norah Henriette Schuster	redirect::Norah Schuster
Norah H. Schuster	redirect::Norah Schuster
Mnistry of Coordination	redirect::Ministry of Coordination
Journal of Organizational behavior	redirect::Journal of Organizational Behavior
Journal of occupational and organizational psychology	redirect::Journal of Occupational and Organizational Psychology
