Title	Category
So Far, So Good...So What! Tour	Other
Draft:Victoria Bellotti	redirect::Victoria Bellotti
The journal of biological chemistry	redirect::Journal of Biological Chemistry
Journal of biological chemistry	redirect::Journal of Biological Chemistry
Moj život je moje blago	redirect::Louis (singer)
Bižuterija	redirect::Jelena Rozga
Oregon Ballot Measure 1 (1912)	redirect::Oregon Equal Suffrage Amendment
Oregon Ballot Measure 9 (1908)	redirect::Oregon Equal Suffrage Amendment
Migrants' Way of Sorrow	redirect::Central American migrant caravans
Oregon Ballot Measure 1 (1910)	redirect::Oregon Equal Suffrage Amendment
Migrant's Way of Sorrow	redirect::Central American migrant caravans
Biyun Chan Temple	Other
Draft:Pueblo Sin Fronteras (activist group)	redirect::Pueblo Sin Fronteras
Brandon J. Fremin	redirect::Brandon Fremin
Category:English folk rock groups	Other/None
Queercore: How to Punk a Revolution	Other
Migrant caravans	redirect::Central American migrant caravans
Chen Horng-chi	Person
Refugee Caravan	redirect::Central American migrant caravans
31st Flying Apsaras Awards	Other/None
1888 United States presidential election in Michigan	Other
Masoes Benyomen Hashlishi	redirect::The Travels of Benjamin III
The Wanderings of Benjamin III	redirect::The Travels of Benjamin III
Cody Poteet	redirect::Miami Marlins minor league players#Cody Poteet
United States national beach handball team	Other
United States women's national beach handball team	Other
Category:Wisconsin–Platteville Pioneers athletic directors	Other/None
Queercore: how to punk a revolution	redirect::Queercore: How to Punk a Revolution
Category:Sonoma State Seawolves athletic directors	Other/None
Migrants' Way of the Cross	redirect::Central American migrant caravans
Category:Jaden Smith albums	Other/None
Category:Sonoma State Seawolves men's basketball coaches	C_Person
Rebecca Dallet	Person
1987 South African Airways Boeing 747 crash	redirect::South African Airways Flight 295
South african airways flight 295	redirect::South African Airways Flight 295
James Albert King	Other/None
AltPress	redirect::Alternative Press (magazine)
Outgrown Things	Other
Battle of Medak Pocket	redirect::Operation Medak Pocket
Ultra-Trail Harricana of Canada	C_Organization
Illinois Mycological Association	Organization
Si Ye Cao	redirect::Joyce Chu
1880 United States presidential election in Michigan	Other
Kelly Frye	Person
Visveswarapuram	C_Location
Doctor Hauzer	Other
George Shoobridge Carr	redirect::G. S. Carr
Georgia Bulldogs equestrian	Other
Great Prince's, Tsar's and Emperor's Hunting in Russia	Other
Fall of Robespierre	redirect::Fall of Maximilien Robespierre
Category:WikiProject Lesotho members	Other/None
Sugar Hill Greenway	Location
Hachioji Trains	redirect::Tokyo Hachioji Bee Trains
Category:WikiProject Liberia members	Other/None
Kuekenthal	redirect::Kükenthal
Hypermethylated	redirect::Methylation
Bad Boy (Red Velvet song)	Other
Shadow: War of Succession	Other
Po Chih Leong	redirect::Po-Chih Leong
SHADOW: War of Succession	redirect::Shadow: War of Succession
Wulai Hot Spring	Location
Miss Russia 2011	Other/None
Bara Hack: The Lost Village of the Higinbothams	redirect::Bara-Hack, Connecticut
30th Flying Apsaras Awards	Other/None
Category:Business incubators of Pakistan	Other/None
2018 YouTube headquarters shooting	redirect::YouTube headquarters shooting
MasterChef Canada (season 5)	Other
Aerodynamite	redirect::Aerodynamic (instrumental)
Electrical box	redirect::Pattress
Denair High School	Other
Computerized (song)	redirect::List of songs recorded by Daft Punk
Drive (Daft Punk song)	redirect::List of songs recorded by Daft Punk
WKRC-DT2	redirect::WKRC-TV#WKRC-DT2 (The CW Cincinnati)]] <!-- [[Draft:WKRC-DT2
Wikipedia:NCHESS	redirect::Wikipedia:WikiProject Chess#Notability of chess players
Enclosure (electrical)	redirect::Electrical enclosure
Category:Slovak basketball coaches	C_Person
Włodzimierz Kamirski	redirect::Vladimir Kamirski
Wirral Wolves	redirect::Merseyside Nighthawks
1936 United States presidential election in Michigan	Other
Social media detoxification	redirect::Digital detox
Nuclear Freeze campaign	Other/None
Actinostella callosa	redirect::Actinostola callosa
Actinostola atrostoma	redirect::Actinostola callosa
Actinostola sibirica	redirect::Actinostola callosa
Catadiomene atrostoma	redirect::Actinostola callosa
Czech Republic Basketball League	redirect::National Basketball League (Czech Republic)
Urticina callosa	redirect::Actinostola callosa
Category:Swingfly songs	Other/None
Brumberg sisters	Person
Harlem Globetrotters: World Tour	Other
Goodbye Yesterday	Other
Wolk (surname)	redirect::Wolk
Igor Matheus Liziero Pereira	redirect::Igor Liziero
Draft:Nostalghia (musician)	redirect::Nostalghia (musician)
Vladimir Kamirski	C_Person
Alberto Paz	Person
Wikipedia:WikiProject Medicine/Stats/Top medical editors 2017 (en)	Other/None
Category:Party-list elections in the Philippines	Other/None
Le Grand High School	Other
Noah Grove	Person
