Title	Category
HP Mid Euro	redirect::HP 30b
HP 40b	redirect::HP 30b#40b
Lamm Fireless Engine Company	redirect::Emile Lamm
The Professional Cricketers' Association	redirect::Professional Cricketers' Association
Category:2018–19 South-West Indian Ocean cyclone season	C_Location
Riama	Other/None
Category:2018–19 Australian region cyclone season	C_Location
Fantastica: The Princesses, The Prince and The Perya	redirect::Fantastica (2018 film)
List of pipeline accidents in the United States in 2006	Other/None
Category:Chifley, New South Wales	C_Location
National Anthem of Turkmenistan	redirect::State Anthem of Turkmenistan
Uhrshawan Battery	redirect::Ershawan Battery
Category:Maroubra, New South Wales	C_Location
Template:IND NH19 sr	Other/None
Rwanda Standard Gauge Railway	Other
Asian racoon	redirect::Raccoon dog
Soluble CD25	redirect::IL2RA
Theo Heemskerk cabinet	Other
Israr Ahmed (cricketer)	Person
German torpedo boat T14	Other
SCD25	redirect::IL2RA
Explosion-proof enclosures	redirect::Electrical equipment in hazardous areas
Omair Yousuf	Person
Scriptosaura	Other/None
German torpedo boat T15	Other
Lamm Fireless engine	redirect::Emile Lamm
List of reccuring Smart Guy Characters	redirect::Smart Guy#Recurring characters
Andy Mohr Field	redirect::Indiana Hoosiers softball
Template:Jessica Molaskey	C_Person
Elza Furtado Gomide	Other/None
List of converts to the Catholic Church from Islam	redirect::List of converts to Catholicism from Islam
Red Bull Music Festival	redirect::Red Bull Music Academy
German torpedo boat T16	Other
Scriptosaura catimbau	redirect::Scriptosaura
Category:St Ives, New South Wales	C_Location
Melissa Cook Stadium	redirect::Notre Dame Fighting Irish softball
German torpedo boat T17	Other
Moscow Methodological Circle	C_Organization
Ust-Koksa	Other
Micro UAV	redirect::Micro air vehicle
Ayutthaya Chronicles	redirect::Ayutthaya Kingdom#Phongsawadan Krung Si Ayutthaya
Vanzosaura	Other/None
Template:IND NH20 sr	Other/None
Bittinger Stadium	redirect::Purdue Boilermakers
Secret Ingredient	Other
German torpedo boat T18	Other
Category:Museums in West Sumatra	Other/None
List of Chinese loanwords in Indonesian	Other/None
Mini UAV	redirect::Miniature UAV
Category:Arncliffe, New South Wales	C_Location
Small UAV	redirect::Miniature UAV
Category:Bayside Council	Other/None
Portal:Arithmetic	Other/None
Draft:Angélica (1994 album)	redirect::Angélica (television host)
Kistefos Træsliberi	redirect::Kistefos Wood Pulp Mill
German torpedo boat T19	Other
Draft:TupiTube	redirect::TupiTube
Heracleum nepalense	Other/None
Annie Murray	Person
Category:Botany, New South Wales	C_Location
Christina Larner	Person
Hindsiclava eupora	Other/None
File:KTMB Oldies102.1 logo.png	C_Location
Draft:Trần dynasty military tactics and organization	redirect::Trần dynasty military tactics and organization
German torpedo boat T20	Other
Army Motor Reserve	Other/None
Eynel Soares	Person
Template:Brightline rail	Other/None
−5 (disambiguation)	redirect::−5
Template:IND NH22 sr	Other/None
Malicious mobile code	redirect::Malware
Wikipedia:WikiProject Spam/LinkReports/federicomayor-eng.blogspot.de	Other/None
Price Field	redirect::Indiana State Sycamores
José (film)	Other
German torpedo boat T21	Other
American Association of Immunologists Lifetime Achievement Award	Other/None
Regenbogenparade	redirect::LGBT rights in Austria#Gay community
Czerwiński CW 5 bis	Other
Ennis Airport	redirect::Ennis Municipal Airport
Random Acts of Violence (film)	Other
Draft:Aniyaa	redirect::Aniyaa
Line 4A (Phnom Penh Bus Rapid Transit)	Other
Elizabeth Jackson (1865-1889)	redirect::Thames Torso Murders
Category:Kogarah, New South Wales	C_Location
Inf. Control	redirect::Information and Computation
Inf Control	redirect::Information and Computation
JETP Lett.	redirect::Journal of Experimental and Theoretical Physics
Draft:Angélica (1995 album)	redirect::Angélica (television host)
JETP Lett	redirect::Journal of Experimental and Theoretical Physics
Rose of My Heart	Other
Margarita Argúas	Person
Suicide Boys	redirect::Suicideboys
SuicideBoys	redirect::Suicideboys
Suicide boys	redirect::Suicideboys
$uicideBoy$	redirect::Suicideboys
Pis'ma Zh. Eksp. Teor. Fiz.	redirect::Journal of Experimental and Theoretical Physics
Drumbo (Tullyhunco)	Other/None
Turija River	redirect::Turiya (river)
Palaeontologica Electronica	redirect::Palaeontologia Electronica
Paleontologia Electronica	redirect::Palaeontologia Electronica
