Title	Category
19-2 Exercise	redirect::Ulchi-Freedom Guardian
Dhyana in Hinduism (Self-knowledge)	redirect::Dhyāna in Hinduism
Exercise 19-2	redirect::Ulchi-Freedom Guardian
University of Wisconsin-Whitewater at Rock County	redirect:::University of Wisconsin–Whitewater at Rock County
Draft:Bennett Smith (kayaker)	redirect::Bennett Smith (kayaker)
Stitch's Alien Encounter Character Greeting!	redirect::Stitch's Great Escape!
Nigeria national football team 1949-59 results	redirect::Nigeria national football team results (1949–59)
Category:Al-Ahli Taizz SC players	Other/None
Andreas Parish Church	redirect::St Andrew's Church, Andreas, Isle of Man
Template:2016-17 in Northern Ireland association football	redirect:::Template:2016–17 in Northern Ireland association football
Template:2018-19 in Northern Ireland association football	redirect:::Template:2018–19 in Northern Ireland association football
Template:2010-11 in Northern Ireland association football	redirect:::Template:2010–11 in Northern Ireland association football
Template:2017-18 in Northern Ireland association football	redirect:::Template:2017–18 in Northern Ireland association football
Rubik R-08 Pilis	Other
Prajna in Buddhism (Insight)	redirect::Prajñā (Buddhism)
Lin Tsai-chueh	redirect::Linden Lin
Category:2010s murders in Nigeria	Other/None
Category:Al-Hilal Al-Sahili players	Other/None
Category:Basketball teams in the Balearic Islands	Other/None
X-625	redirect::List_of_Lilo_%26_Stitch_characters#Reuben_(X-625)
Category:Murders in Nigeria by decade	Other/None
Category:Al-Ittihad SCC (Ibb) players	Other/None
The Third Bank of the River (short story)	Other/None
Category:Songs written by Michael Franti	Other/None
Category:Al-Shula players	Other/None
Category:Crimes in Nigeria by decade	Other/None
Roger Trigg	Person
Template:Did you know nominations/Rhycherus filamentosus	Other/None
Category:Basketball teams in Extremadura	Other/None
Huawei Honor Magic 2	redirect::Honor (brand)#Products
Category:May 22 San'a players	Other/None
Rana Ahmad	Person
Category:Al-Wehda Club (Sana'a) players	Other/None
Category:Countries in Sub-Saharan Africa	Other/None
Category:Hassan Abyan players	Other/None
Sanguibacteroides	Other/None
2011–12 V-League (South Korea)	Other
Category:Basketball teams in Aragon	Other/None
Category:2010s murders by country	Other/None
Category:Al-Saqr SC players	Other/None
Draft:Get to the Boat	Other
Banks Peninsula Volcano	A_Location
Template:Professional wrestling in Puerto Rico	redirect::Template:Professional wrestling in the United States
Pesticide approval	redirect::Pesticide#Regulation
Category:Al-Tilal SC players	Other/None
Tsai Ji-chun	redirect::Jason Tsai
Geology of the West Coast Region	Other/None
Shaw-Lan Wang	redirect::Wang Shaw-lan
Roddy MacGregor	Person
2019 IBU Open European Championships	C_Organization
Ansar Abbas	Person
Year -1	redirect::1 BC
The Turtles of Venezuela	Other
John Wu (cardinal)	redirect::John Baptist Wu
Category:2010s murders in North America	Other/None
Benjamin of Petersburg	redirect::Benjamin of Petrograd
Mano Negra (disambiguation)	redirect::Black Hand
Svein Are Andreassen	C_Person
Jonna Jonerup	Person
List of Australian hip hop musicians	Other/None
Draft:Tawfiq Ali Mansour	redirect::Emad Mansoor
Matthew Stokys	C_Person
Tawfiq Ali Mansour	redirect::Emad Mansoor
Former Military Chapel (Bachelor Quarters)	redirect::Former Military Chapel (Bachelor Quarters) (Alcatraz Island)
Cross-country skiing at the 1988 Winter Olympics – Men's 30 kilometre classical	C_Person
Former Military Chapel (Bachelor Quarters), Alcatraz	redirect::Former Military Chapel (Bachelor Quarters) (Alcatraz Island)
Category:Murders in North America by decade	Other/None
British Guiana 1856 1c magenta	redirect::British Guiana 1c magenta
2018 Yamaguchi gubernatorial election	Other/None
Draft:Ala Addin Mahdi	redirect::Ala Addin Mahdi
Bjørn Ludvigsen	C_Person
M.mediawiki.org	redirect::MediaWiki
Gonow Way	Other
Nazreon Reid	redirect::Naz Reid
Chrysa (disambiguation)	redirect::Chrysa
Gonow Xingwang	redirect::Gonow Way
Gonow Way L	redirect::Gonow Way
Category:2010s murders by continent	Other/None
Gonow Xingwang L	redirect::Gonow Way
Loli (term)	redirect::Lolita (term)
Gonow Xingwang CL	redirect::Gonow Way
Benjamin Sana Wyatt	redirect::Ben Wyatt
Gonow Way CL	redirect::Gonow Way
Gonow Way M1	redirect::Gonow Way
Same-sex marriage in Nuevo León	Other/None
Gonow Way M2	redirect::Gonow Way
Gonow Xingwang M2	redirect::Gonow Way
Gonow Xingwang M1	redirect::Gonow Way
Gonow Minivan	redirect::Gonow Way
Kenneth George Wyatt	redirect::Ken Wyatt
Gonow Dual Luck	redirect::Huanghai Challenger
Per Egil Swift	C_Person
Gonow Finite	redirect::Huanghai Challenger
Gonow Troy	redirect::Huanghai Challenger
Gonow Troy 500	redirect::Huanghai Challenger
Joseph Ha Chi-shing	redirect::Joseph Ha
Category:Yemeni football biography stubs	C_Person
Francisco José Alcaraz	Person
Category:Gypsy Sun and Rainbows members	C_Person
C. J. Stranks	redirect::Charles Stranks
