Title	Category
Suga's Interlude	C_Person
Category:Dell Publishing books	Other/None
Kurt Cobain Was Murdered	redirect::Suicide of Kurt Cobain#Hypotheses
Olga Carmona	Person
Rio de Janeiro Metro Line 4	redirect::Line 4 (Rio de Janeiro)
Category:Delacorte Press books	Other/None
Alpha Betty Saga	redirect::King (company)#Games
Blossom Blast Saga	redirect::King (company)#Games
Comet Network	redirect::Comet (TV network)
HeraldNet.com	redirect::The Everett Herald
Madden NFL Mobile 15	redirect::Madden NFL Mobile
Madden NFL Mobile 16	redirect::Madden NFL Mobile
Krenitsyn (volcano)	redirect::Tao-Rusyr Caldera
Category:August 2004 sports events in Canada	C_Organization
CityLink Yellow (MTA Maryland)	redirect::Route 5 (MTA Maryland)
Liverpool, Louisiana	Location
Dakshina Gangotri Glacier	redirect::Dakshin Gangotri Glacier
Category:August 2004 events in Canada	C_Organization
Madden NFL Mobile 17	redirect::Madden NFL Mobile
Madden NFL Mobile 18	redirect::Madden NFL Mobile
Category:People from Klimovichskiy Uyezd	Other/None
Viviane Araújo (fighter)	Person
IndARC Observatory	redirect::IndARC
Category:August 2004 sports events in the United Kingdom	C_Organization
Magical Drop Touch	redirect::Magical Drop#Games
Draft:Dante Bini	redirect::Dante Bini
Category:August 2004 events in the United Kingdom	C_Organization
Category:Politics of Mie Prefecture	Other/None
Emma Powell	Person
Provinz Preußen	redirect::Province of Prussia
Category:Reconfiguration	Other/None
Reconfiguration	Other/None
Bea Moten-Foster	Other/None
Police Bullets	Other
Gallus (Professional Wrestling)	redirect::Joe Coffey (wrestler)
Renegade Nation	Company
Harold Wenstrom	Person
Vidyardhi	Other
1940 Australian Championships - Mixed Doubles	redirect:::1940 Australian Championships – Mixed Doubles
Wikipedia:Articles for deletion/Timeline of the war in Donbass (January-March 2016)	redirect:::Wikipedia:Articles for deletion/Timeline of the war in Donbass (January–March 2016)
Category:Politics of Nara Prefecture	Other/None
Category:Politics of Wakayama Prefecture	Other/None
Cinciarini, Andrea	redirect::Andrea Cinciarini
1940 Australian Championships - Women's Doubles	redirect:::1940 Australian Championships – Women's Doubles
Cionna, Andrea	redirect::Andrea Cionna
Cipressa, Andrea	redirect::Andrea Cipressa
Cisco, Andrea	redirect::Andrea Cisco
Cistana, Andrea	redirect::Andrea Cistana
Clausen, Andrea	redirect::Andrea Clausen
Category:February 2004 sports events in Oceania	C_Organization
Clearfield, Andrea	redirect::Andrea Clearfield
Clemente, Andrea	redirect::Andrea Clemente
Cocco, Andrea	redirect::Andrea Cocco
Cochran, Andrea	redirect::Andrea Cochran
Ice hockey at the 1986 Asian Winter Games - Men	redirect:::Ice hockey at the 1986 Asian Winter Games#Results
Coda, Andrea	redirect::Andrea Coda
Cola, Andrea	redirect::Andrea Cola
Collarini, Andrea	redirect::Andrea Collarini
Colli, Andrea	redirect::Andrea Colli
Collinelli, Andrea	redirect::Andrea Collinelli
Ice hockey at the 1996 Asian Winter Games - Men	redirect:::Ice hockey at the 1996 Asian Winter Games#Men
Colombo, Andrea	redirect::Andrea Colombo
2019–20 Sam Houston State Bearkats women's basketball team	Other
Colpani, Andrea	redirect::Andrea Colpani
Cominelli, Andrea	redirect::Andrea Cominelli
Commodi, Andrea	redirect::Andrea Commodi
Congreaves, Andrea	redirect::Andrea Congreaves
2018-19 Algerian Women's Championship	redirect:::2018–19 Algerian Women's Championship
Consigli, Andrea	redirect::Andrea Consigli
Contarini, Andrea	redirect::Andrea Contarini
Conte, Andrea	redirect::Andrea Conte
Conti, Andrea	redirect::Andrea Conti
2019-20 Texas A&M-Corpus Christi Islanders women's basketball team	redirect:::2019–20 Texas A&M–Corpus Christi Islanders women's basketball team
Coote, Andrea	redirect::Andrea Coote
Coppolino, Andrea	redirect::Andrea Coppolino
Vizcaya (insect)	Other/None
Corbellari, Andrea	redirect::Andrea Corbellari
Cornwall, Andrea	redirect::Andrea Cornwall
Corr, Andrea	redirect::Andrea Corr
List of members of the Italian Senate, 2018-	Other/None
Corrado, Andrea	redirect::Andrea Corrado
Corsali, Andrea	redirect::Andrea Corsali
Corsaro, Andrea	redirect::Andrea Corsaro
Coss, Andrea	redirect::Andrea Coss
Costa, Andrea	redirect::Andrea Costa
Ice hockey at the 1996 Asian Winter Games - Women	redirect:::Ice hockey at the 1996 Asian Winter Games#Women
Cottini, Andrea	redirect::Andrea Cottini
Covi, Andrea	redirect::Andrea Covi
Cozzolino, Andrea	redirect::Andrea Cozzolino
Crawford, Andrea	redirect::Andrea Crawford
Crespo, Andrea	redirect::Andrea Crespo
Crestadoro, Andrea	redirect::Andrea Crestadoro
Crisanti, Andrea	redirect::Andrea Crisanti
Cristiano, Andrea	redirect::Andrea Cristiano
Crosariol, Andrea	redirect::Andrea Crosariol
Cunningham, Andrea	redirect::Andrea Cunningham
Cupi, Andrea	redirect::Andrea Cupi
Curiale, Andrea	redirect::Andrea Curiale
Czanik, Andrea	redirect::Andrea Czanik
Sheath blight of rice	Other/None
