Title	Category
Everest Region	redirect::Khumbu
Uwatenage	redirect::Kimarite#Uwatenage_上手投げ
1947 US House of Representatives elections	redirect::1947 United States House of Representatives elections
1949 US House of Representatives elections	redirect::1949 United States House of Representatives elections
1951 US House of Representatives elections	redirect::1951 United States House of Representatives elections
Betty (name)	redirect::Betty
Bettina Hoffmann (artist)	Person
1953 US House of Representatives elections	redirect::1953 United States House of Representatives elections
Osaka keumgang Korean School	redirect::Kongo Gakuen
Tezaur folcloric	Other
1955 US House of Representatives elections	redirect::1955 United States House of Representatives elections
Siltanen	Other/None
Opendoor	Company
1957 US House of Representatives elections	redirect::1957 United States House of Representatives elections
Kyoto Korean School	redirect::Kyoto International Junior and Senior High School
Siltala (surname)	redirect::Siltala
1959 US House of Representatives elections	redirect::1959 United States House of Representatives elections
1961 US House of Representatives elections	redirect::1961 United States House of Representatives elections
Category:Family of Carlos Santana	Other/None
Hanoi Korean School	redirect::Korean International School in Hanoi
Samuel Bell Waugh	redirect::Samuel Waugh
Media house	redirect::Mass media
Hochiminh Korean School	redirect::Korean International School, HCMC
Silvasy	redirect::Stephen Silvasy Jr.
1963 US House of Representatives elections	redirect::1963 United States House of Representatives elections
Philippines Korean School	redirect::Korean International School Philippines
Draft:Ezekiel Reyes	redirect::List of Sons of Anarchy and Mayans M.C. characters#Ezekiel Reyes
1965 US House of Representatives elections	redirect::1965 United States House of Representatives elections
Baranis	Other/None
Brazil Korean School	redirect::Colégio Polilogos
1999 World Wrestling Championships – Men's freestyle 130 kg	Other/None
Category:Churchyards in Wales	Other/None
1969 US House of Representatives elections	redirect::1969 United States House of Representatives elections
Whimsy Cards	Other/None
Jessic Ngankam	Person
Draft:Avery Elias Plaw	Person
Poskota	redirect::Pos Kota
1981 US House of Representatives elections	redirect::1981 United States House of Representatives elections
Ghana Independence Act 1957	C_Organization
Rosa 'Red Gold'	Other
1983 US House of Representatives elections	redirect::1983 United States House of Representatives elections
Peter Keller (disambiguation)	redirect::Peter Keller
1985 US House of Representatives elections	redirect::1985 United States House of Representatives elections
Hendrik Berend Dorgelo	redirect::Henk Dorgelo
Draft:Bettina Hoffmann (artist)	redirect::Bettina Hoffmann (artist)
File:Gandhinagar Second Street.jpg	redirect::File:Gandhinagar 2nd Street.jpg
1987 US House of Representatives elections	redirect::1987 United States House of Representatives elections
1989 US House of Representatives elections	redirect::1989 United States House of Representatives elections
Silvernail	redirect::George Silvernail
1991 US House of Representatives elections	redirect::1991 United States House of Representatives elections
1993 US House of Representatives elections	redirect::1993 United States House of Representatives elections
Gaelcholáiste Dhoire	A_Location
1997 US House of Representatives elections	redirect::1997 United States House of Representatives elections
"Ezekiel ""EZ"" Reyes"	redirect::List of Sons of Anarchy and Mayans M.C. characters#Ezekiel Reyes
1999 US House of Representatives elections	redirect::1999 United States House of Representatives elections
This Publican	Other/None
2001 US House of Representatives elections	redirect::2001 United States House of Representatives elections
Category:Sports organizations disestablished in the 1870s	Other/None
Category:Sports organizations disestablished in the 1880s	Other/None
Category:Sports organizations disestablished in the 1890s	Other/None
Institutes of higher education	redirect::Educational institution
Category:Sports organizations disestablished in the 1900s	Other/None
2003 US House of Representatives elections	redirect::2003 United States House of Representatives elections
Template:Hyderabad FC squad	Other/None
Category:Sports organizations disestablished in the 1910s	Other/None
Category:Sports organizations disestablished in the 1920s	Other/None
Category:Sports organizations disestablished in the 1930s	Other/None
Category:Sports organizations disestablished in the 1940s	Other/None
Category:Sports organizations disestablished in the 1950s	Other/None
Category:Sports organizations disestablished in the 1960s	Other/None
Category:Sports organizations disestablished in the 1970s	Other/None
2005 US House of Representatives elections	redirect::2005 United States House of Representatives elections
Category:Sports organizations disestablished in the 1980s	Other/None
Category:Sports organizations disestablished in the 1990s	Other/None
The Devil in Satin	redirect::This Publican
Category:Sports organizations disestablished in the 2000s	Other/None
2007 US House of Representatives elections	redirect::2007 United States House of Representatives elections
Pradhan Mantri Matsya Sampada Yojana	Other/None
2009 US House of Representatives elections	redirect::2009 United States House of Representatives elections
Category:American football people from Georgia (U.S. state)	C_Person
2011 US House of Representatives elections	redirect::2011 United States House of Representatives elections
Warmth (album)	Other
Draft:Noah Kagan	Person
Preußische Hauptkadettenanstalt	Other/None
2013 US House of Representatives elections	redirect::2013 United States House of Representatives elections
2015 US House of Representatives elections	redirect::2015 United States House of Representatives elections
2017 US House of Representatives elections	redirect::2017 United States House of Representatives elections
Bay station (disambiguation)	redirect::Bay (disambiguation)#Transport
2019 US House of Representatives elections	redirect::2019 United States House of Representatives elections
1991–92 Pepperdine Waves men's basketball team	Other
Ali Mohamed Muheeb	Person
2007 Junior Pan American Rhythmic Gymnastics Championships	Other/None
Category:English beach volleyball players	C_Person
Draft:Shama Mohamed	Person
Ali Muheeb	redirect::Ali Mohamed Muheeb
Rock wit U	redirect::Rock wit U (Awww Baby)
Category:1991–92 West Coast Conference men's basketball season	Other/None
Stefani Iotova	Person
Draft:Gilbert Marguth	redirect::Gilbert Marguth
Chiang Chieh-an	Person
