Title	Category
Waterhouse's swamp rat	Other/None
The Rake's Progress (film)	Other
Oman bullhead shark	Other/None
Chockablock	redirect::Chock-A-Block
Scolomys ucayalensis	Other/None
Heterodontus omanensis	redirect::Oman bullhead shark
SS-NX-30 Bulava	redirect::RSM-56 Bulava
Antonio del Andrade	redirect::António de Andrade
Bindery	Other/None
Rio de Janeiro arboreal rat	Other/None
Master of Crossbowmen	Other/None
Rokuro Yashiro	redirect::Yashiro Rokurō
The Hunted Bridge	redirect::The Haunted Bridge
Pseudoryzomys	Other/None
Sverre Kolterud	Person
Edie brickell	redirect::Edie Brickell
Matase Alba	redirect::Iris (Romanian band)
Interstate numbering standards	redirect::Interstate Highway System
South Carolina Club for Growth	redirect::Club for Growth
Eternal progression	redirect::Exaltation (Mormonism)
What I Want (Dead or Alive song)	C_Person
Fiber reactive dyes	redirect::Reactive dye
Betty Quinlin	redirect::The Adventures of Jimmy Neutron, Boy Genius
Winnilers	redirect::Lombards
Ontario Superior Court	redirect::Ontario Superior Court of Justice
Brazilian arboreal mouse	Other/None
Corpse Bride (soundtrack)	redirect::Corpse Bride#Soundtrack
U-Pop	C_Location
Red-nosed mouse	Other/None
The Mystery of the Brass Bound Trunk	Other
Boldog, Slovakia	Location
Greater Wilfred's mouse	Other/None
Acid dyes	redirect::Acid_dye
If You Could Play Forever	redirect::List of Yu Yu Hakusho episodes
Template:Schools in Cavite City	Other/None
Sri Mahamariamman Temple, Kuala Lumpur	A_Location
Hamuliakovo	Location
Heir Apparent (book)	redirect::Vivian Vande Velde
Criticism on Ahmadiyyat1	redirect::Views on Ahmadiyya
Hrubá Borša	Location
Hruba Borsa	redirect::Hrubá Borša
Nicole Stafford	C_Person
2006 Swedish general election computer infringement affair	Other/None
Zygodontomys brevicauda	Other/None
Kalinkovo	Location
Pierre Langlois (economist)	C_Person
Contemporary Political Theory	Other
SLIME	Other
Dmitry Chernov	C_Person
Tanin Yamaya	redirect::Yamaya Tanin
Category:User namespace themed userbox galleries	Other/None
Harold MacDowell	C_Person
Phaenomys ferrugineus	redirect::Rio de Janeiro arboreal rat
Pseudoryzomys simplex	redirect::Pseudoryzomys
Ivanka pri Dunaji	Location
The Mystery at the Moss-Covered Mansion	Other
Rhagomys rufescens	redirect::Brazilian arboreal mouse
Mohamed Nechle	redirect::Mohammed Nechle
Rovinka	Location
I'd Do Anything (Dead or Alive song)	C_Person
Tenbury & Bewdley railway	redirect::Tenbury and Bewdley Railway
Rhipidomys gardneri	redirect::Gardner's climbing mouse
Hurbanova Ves	Location
Rhipidomys leucodactylus	redirect::White-footed climbing mouse
Mustafa Aid Idir	redirect::Mustafa Ait Idir
Rhipidomys macconnelli	redirect::MacConnell's climbing mouse
Secondary calculus and cohomological physics	Other/None
Rhipidomys mastacalis	redirect::Atlantic Forest climbing mouse
Mark dynamix	redirect::Mark Dynamix
Dynamic game balancing	redirect::Dynamic game difficulty balancing
10000 maniacs	redirect::10,000 Maniacs
Game Over (YuYu Hakusho)	redirect::List of Yu Yu Hakusho episodes#ep83
Me V. The Angry Mob	redirect::The World/Inferno Friendship Society
User Unfriendly (book)	redirect::Vivian Vande Velde
Kuwait parliamentary election, 2006	redirect::2006 Kuwaiti general election
Dorit Beinish	redirect::Dorit Beinisch
Rhipidomys nitela	redirect::Splendid climbing mouse
WBCB (AM)	C_Location
Harald Bosio	C_Person
Scapteromys tumidus	redirect::Waterhouse's swamp rat
Wyre Forest line	redirect::Tenbury and Bewdley Railway
Sigmodon alstoni	redirect::Alston's cotton rat
Woofferton branch	redirect::Tenbury and Bewdley Railway
Sigmodon hispidus	redirect::Hispid cotton rat
Thalpomys cerradensis	redirect::Cerrado mouse
The Quest of the Missing Map	Other
Žaliakalnis	Location
New England Music Camp	Location
Thalpomys lasiotis	redirect::Hairy-eared cerrado mouse
List of tallest structures in Japan	Other/None
Thaptomys nigrita	redirect::Blackish grass mouse
Text books	redirect::textbook
Southern Democratic Alliance	Other
Anton Levay	redirect::Anton LaVey
Wiedomys pyrrhorhinos	redirect::Red-nosed mouse
VeloBind	Other/None
Uncomputable number	redirect::computable number
Wilfredomys oenax	redirect::Greater Wilfred's mouse
2006 Broadcast TV Fall Primetime Lineup	redirect::2006–07 United States network television schedule
MC Slug	redirect::Slug (rapper)
