Title	Category
Triple conjunction (astronomy)	redirect::Triple conjunction
Occultation (astronomy)	redirect::Occultation
Sylvia Chiffons	redirect::The Chiffons
Miss Nevada	Organization
Sun Girl (Marvel comics)	redirect::Sun Girl (Marvel Comics)
Sylvia Peterson Chiffons	redirect::The Chiffons
Miss New Hampshire	Organization
Miss New Jersey	Other/None
Miss New Mexico	Other/None
Miss North Dakota	Organization
Peter Weatherson	Person
Baby Fever	redirect::List of That '70s Show episodes#Season 3 (2000â€“01)
Donald Hardman	Person
Polynikes	redirect::Gates of Fire
United States National Health Care Act	Other
Mount Lyell (Canada)	Location
Ivan Pliushch	redirect::Ivan Plyushch
Aaron Krohn	Person
Maxillofacial surgeon	redirect::Oral and maxillofacial surgery
Kukuri	redirect::Kukri
Antigenes	Other/None
Category:Dances of Polynesia	Other/None
Port Manatee	Location
Armorial of Europe	Other/None
Great Plains Energy	Company
Stephan Breuing	C_Person
Great Plains Energy Incorporated	redirect::Great Plains Energy
AVC/H.264	redirect::Advanced Video Coding
Wikipedia:Notice board for India-related topics/Reports	Other/None
Portal:Music/DateOfBirth/September 30	C_Person
Charles Aurelius Smith	A_Person
The Lucky Guy	Other
Source Four PARNel	redirect::Source Four PAR
One Last Time Live in Concert	C_Person
Virus (1980 film)	Other
Category:Williams College	Other/None
Langemak Bay	Other/None
Category:Portuguese female singers	C_Person
Charles A. Smith	redirect::Charles Smith
Widdlesworth	Person
East germany	redirect::East Germany
Igeum-dong	C_Location
Handmade designer jewelry	redirect::Handmade jewelry
Category:Portuguese male singers	C_Person
Wikipedia:Mediation Cabal/Cases/2006-09-19 Gabrielangel Encyclopedic Entry	Other/None
Appanoose County Courthouse	Location
MPEG LA	Company
MPEG-LA	redirect::MPEG LA
Marvin & Johnny	Other/None
Steve Took's Shagrat	redirect::Shagrat (band)
Eli Wiesel	redirect::Elie Wiesel
List of mountains of Alberta	C_Location
Template:User PA res	redirect::Template: User Pennsylvania
Moscow War Memorial	redirect::Poklonnaya Hill
Watson, South Australia	redirect::Trans-Australian Railway
Por Una Cabeza	redirect::Por una Cabeza
Kilogram per centimeter squared	redirect::Kilogram-force per square centimetre
Martindale: The Complete Drug Reference	Other
Mind Reflection	redirect::Mind Reflection (band)
Martindale pharmacopoeia	redirect::Martindale: The Complete Drug Reference
New York Community Bank	Company
Steve Armitage	C_Person
Blood of the Daleks	Other
Martindale: The Extra Pharmacopoeia	redirect::Martindale: The Complete Drug Reference
Otohuke	redirect::Otofuke, Hokkaido
Aboriginal australian place names	redirect::List of Australian place names of Aboriginal origin
Bad World	Other
Highest genicular artery	redirect::Descending genicular artery
Graham Gooch's Cricket	redirect::Graham Gooch's Test Cricket
Horror of Glam Rock	Other
Extern variable	redirect::External variable
Gordon J Melton	redirect::J. Gordon Melton
Legion of Steel	redirect::List_of_Dragonlance_characters#Legion_of_Steel
Template:Germany squad 1998 FIFA World Cup	Other/None
Monqui	Other/None
Aspect (astrology)	redirect::Astrological aspect
Otohuke, Hokkaido	redirect::Otofuke, Hokkaido
Lower Bucca, New South Wales	C_Location
Reproductive synchrony	Other/None
Armor Project	redirect::Yuji Horii
Battle of Cerisoles	redirect::Battle of Ceresole
"Wikipedia:Mediation Cabal/Cases/2006-09-19 ""Gabrielangel"" Recurrent Deletion By Adam Bishop"	Other/None
The Fulcrum	redirect::Fulcrum
Template:Germany squad 1994 FIFA World Cup	Other/None
Aboriginal kinship	redirect::Australian Aboriginal kinship
Bodegisel	Other/None
The Child Garden	Other
National Midget Auto Racing Hall of Fame	Other/None
2006 Sportsland Sugo 1000km	redirect::2006 Japan Le Mans Challenge
John Newland Maffitt (1819-1886)	redirect::John Newland Maffitt (privateer)
Tokati Subprefecture	redirect::Tokachi Subprefecture
Poryphoric hemophilia	redirect::Porphyria
Vinson Filyaw	Person
Louis Uchitelle	C_Person
1991 Ukrainian presidential election	C_Organization
Sorati Subprefecture	redirect::Sorachi Subprefecture
The World Is Not Enough (soundtrack)	Other
Synchronous spawning	redirect::Reproductive synchrony
Kiyoshi Sakai	C_Person
.375 HH	redirect::.375 H&H Magnum
