Title	Category
Ecgwine of Evesham	redirect::Egwin of Evesham
Dracula Vlad Ţepeş	redirect::Dracula (Castlevania)
Brian Osborne	Person
Paul Gruber	A_Person
No Surrender...No Retreat to No Surrender	Other
North Cliffe	Location
Dante Medina	redirect::List of One Life to Live characters (1980s)#Dante Medina
Eliezer ben Jacob I	Other/None
Category:Maritime incidents in 1841	Other/None
Walther Ruttmann	redirect::Walter Ruttmann
Julia Wheaton	redirect::List of One Life to Live characters (1980s)#Julia Wheaton
Simon b. 'Azzai	redirect::Simeon ben Azzai
Duncan Mills Bridge	Location
Template:Spain squad 1978 FIFA World Cup	Other/None
Kulwant Singh Pannu	Person
Brassaiopsis	Other/None
Donnie Burns	C_Person
Kao Chih-kang	Person
Glade jul	redirect::Glade Jul
Euaraliopsis	redirect::Brassaiopsis
Grushvitzkya	redirect::Brassaiopsis
Pseudobrassaiopsis	redirect::Brassaiopsis
Wardenia	redirect::Brassaiopsis
Oshere of the Hwicce	redirect::Oshere
Gaynor Fairweather	C_Person
Port of trieste	redirect::Port of Trieste
Berlin Symphony of a City	redirect::Berlin: Symphony of a Metropolis
Daytona 24 hours	redirect::24 Hours of Daytona
Category:Maritime incidents in 1967	C_Person
Universal Small Souljah	Other
Gwyn Thomas (footballer)	Person
Kao Cheng-hua	Person
Eanfrith of the Hwicce	redirect::Æthelwealh of Sussex
Soria Moria	Other
Category:Doctor Who fandom	Other/None
Guilford,Ct	redirect::Guilford, Connecticut
Battle of Najaf	Other/None
Leslie Garratt	redirect::Lesley Garrett
Schoten, Netherlands	Other/None
Eastwater Cavern	Location
Hananiah b. Ḥakinai	redirect::Hanina ben Hakinai
Durovernum	redirect::Durovernum Cantiacorum
Category:Maritime incidents in 1743	Other/None
Beletwein	redirect::Beledweyne
Boonie hat	Other/None
Gift of Love	Other
Indian Ford Bridge	Location
Manuel Garcia II.	redirect::Manuel García (baritone)
List of countries by Gini index	redirect::List of countries by income equality
2000 Italian Formula 3000 Championship	Other/None
Ger Brennan	C_Person
Barry Jackson (director)	Person
Beverly Township, Adams County, Illinois	Location
Duroliponte	C_Location
Northern Irish people	redirect::People of Northern Ireland
Comes a horseman (Highlander)	redirect::Highlander: The Series (season 5)#ep99
List of countries inequality of income	redirect::List of countries by income equality
Dezső Földes	C_Person
Category:Townships in Adams County, Illinois	C_Location
Eanhere of the Hwicce	redirect::Eanhere
Category:Articles with dead external links	Other/None
Rosemarie Waldrop	redirect::Rosmarie Waldrop
Tochinishiki Kiyotaka	Person
Swimming at the 1912 Summer Olympics – Men's 100 metre freestyle	C_Person
Ernest Cable, 1st Baron Cable	C_Person
Food play	Other/None
Midrash Hallel	redirect::Midrash Tehillim
File:Mortal Kombat poster.jpg	Other/None
Category:Maritime incidents in 1864	Other/None
Creature from the Pit	redirect::The Creature from the Pit
Sint Pancras	Location
Antonije Abramović	Person
RBAI	redirect::Royal Belfast Academical Institution
Category:Spokane Public Facilities District	Other/None
Wakanohana Kanji I	Person
Claude Roy Kirk	redirect::Claude R. Kirk Jr.
Midrash Haggadah	redirect::Aggadah
Focus Group Holdings Limited	Company
Colin Prenderville	C_Person
FGED Society	Organization
Bill and Bobbie Irvine	Location
Midrash Halakah	redirect::Midrash halakha
Professional Latin	redirect::World Latin Dance Champions
Battle of Lagos (1693)	Other
Navy of Chile	redirect::Chilean Navy
Lake Moels	Other
London Mills Bridge	Location
Bobbie Irvine	redirect::Bill and Bobbie Irvine
SV Fortuna Magdeburg	Other
Burton Township, Adams County, Illinois	Location
File:Pen Pusher logo.png	Other/None
Time Flower	redirect::Pokémon: Lucario and the Mystery of Mew
Bill Irvine	redirect::Bill and Bobbie Irvine
Category:Maritime incidents in 1815	Other/None
Rudolf A. Makkreel	redirect::Rudolf Makkreel
Gutta Mixx	Other
Salpeter War	redirect::War of the Pacific
Battle of Guard Hill	C_Organization
Wakanohana Kanji	redirect::Wakanohana
Luko Zore	Person
