Title	Category
Morin-Heights	Location
Getafe CF	Other
Human interface guidelines	Other/None
Sweedler notation	redirect::Coalgebra#Sweedler notation
Sweedler's notation	redirect::coalgebra
Co-commutative	redirect::coalgebra
Cocommutative	redirect::Coalgebra#Further concepts and facts
Pietro Cataldi	Other/None
Pietro Antonio Cataldi	redirect::Pietro Cataldi
Peace of westphalia	redirect::Peace of Westphalia
Cataldi	Other/None
97th United States Congress	Other
Rick Hearst	Person
Ontario parliament	redirect::Legislative Assembly of Ontario
Thirty year's war	redirect::Thirty Years' War
Ontario legislature	redirect::Legislative Assembly of Ontario
Flex time	redirect::Flextime
Error handler	redirect::Exception handling
War of three henrys	redirect::War of the Three Henrys
War of the three henry's	redirect::War of the Three Henrys
War of the three henries	redirect::War of the Three Henrys
Herman E. Talmadge	redirect::Herman Talmadge
Liberals (Finland)	Other
Enterobacterales	Other/None
Nitrogen assimilation	Other/None
Nepomuk	Location
Chromatiales	redirect::Purple sulfur bacteria
Alex Ramsey	redirect::Alexander Ramsey
Volt Records	redirect::Stax Records
M1A1 carbine	redirect::M1 carbine
Theodore Arthur Burrows	Person
Hms sheffield	redirect::HMS Sheffield
Viva Records (U.S.)	C_Company
Kladruby (Tachov District)	Location
Abbe (crater)	A_Location
Abbey of Kladruby	redirect::Kladruby (Tachov District)
RMS Laconia (1911)	Other
Kladrau	redirect::Kladruby (Tachov District)
Abbey of Kladrau	redirect::Kladruby (Tachov District)
SS Laconia (1911)	redirect::RMS Laconia (1911)
Novaya Gazeta	Other
V.I.P. Records	redirect::Motown#Secondary R&B labels
The Ayla Project	redirect::Ayla
Abul Wafa (crater)	A_Location
RMS Laconia (1921)	C_Location
Ayla (name)	Other
SS Laconia (1922)	redirect::RMS Laconia (1921)
Villarreal CF	Other
U.S. Secretary of Health, Education, and Welfare	redirect::United States Secretary of Health and Human Services
Rape fantasy	Other/None
Aitken (crater)	A_Location
Jahre Viking	redirect::Seawise Giant
Alden (crater)	A_Location
Nitrosomonadales	Other/None
U.S. Secretary of Commerce and Labor	redirect::United States Department of Commerce and Labor
Elizabeth Thornburg	redirect::Betty Hutton
Ambassadorial residence	redirect::Diplomatic mission
James Duncan McGregor	Person
Elizabeth June Thornburg	redirect::Betty Hutton
Chalet	Other/None
Oriente Province	Other/None
Ezra T. Benson	Person
Grammy Award for Best Rock Album	Other
Al-Khwarizmi (crater)	A_Location
Alter (crater)	A_Location
Liberaalit	redirect::Liberals (Finland)
Linkword	C_Company
Amici (crater)	A_Location
Swan Hunter & Wigham Richardson	redirect::Swan Hunter
Category:Municipalities of Norway	C_Location
Swan, Hunter and Wigham Richardson	redirect::Swan Hunter
Category:Sør-Trøndelag	Other/None
Swan, Hunter & Wigham Richardson	redirect::Swan Hunter
Cádiz CF	Other
Category:Cluj-Napoca	C_Location
Neil Cavuto	Person
Haines Junction	Location
Anders (crater)	A_Location
Eduardo Dato	A_Person
Western beaked gecko	Other/None
RMS Mauretania	Other/None
U.S. Secretary of Veterans Affairs	redirect::United States Secretary of Veterans Affairs
Ecological wisdom	redirect::Ecosophy
Nord trøndelag	redirect::Nord-Trøndelag
Cherry (comics)	Other
Category:Languages of Romania	Other/None
South Slavonic languages	redirect::South Slavic languages
Administrative divisions of Ukraine	Other/None
Category:Nord-Trøndelag	Other/None
Lamellophone	Other/None
RMS Mauritania	redirect::RMS Mauretania
William Johnston Tupper	Person
Deportivo Alavés	Other
Judo at the 1980 Summer Olympics	C_Person
Marímbula	Other
Category:Carmarthenshire	Other/None
Harlau	redirect::Hârlău
Floating Storage and Offloading unit	redirect::Floating production storage and offloading
Somethin' Bitchin' This Way Comes	redirect::Something Bitchin' This Way Comes
Category:Møre og Romsdal	Other/None
